(New) Cell Type	(Old) Cell Type
CD4pp_CD25__IL17__PMA_Ionomycin_stimulated_MACS_purified_Th_Primary_Cells	CD4pp_CD25__IL17__PMA_Ionomycin_stimulated_MACS_purified_Th_Primary_Cells
CD4pp_CD25__Th_Primary_Cells	CD8_Naive_Primary_Cells
CD4pp_CD25pp_CD127__Treg_Primary_Cells	CD4pp_CD25__CD45RApp_Naive_Primary_Cells
HeLa_S3_Cervical_Carcinoma	CD4pp_CD25int_CD127pp_Tmem_Primary_Cells
HMEC_Mammary_Epithelial	CD8_Memory_Primary_Cells
GM12878_Lymphoblastoid	CD3_Primary_Cells_Peripheral_UW
Ovary	CD4_Memory_Primary_Cells
CD3_Primary_Cells_Cord_BI	CD4_Naive_Primary_Cells
CD4pp_CD25__IL17pp_PMA_Ionomcyin_stimulated_Th17_Primary_Cells	HSMMtube_Skeletal_Muscle_Myotubes_Derived_from_HSMM
CD4pp_CD25__CD45ROpp_Memory_Primary_Cells	Fetal_Adrenal_Gland
Sigmoid_Colon	CD3_Primary_Cells_Cord_BI
K562_Leukemia	CD4pp_CD25__Th_Primary_Cells
Pancreatic_Islets	CD4pp_CD25__CD45ROpp_Memory_Primary_Cells
Peripheral_Blood_Mononuclear_Primary_Cells	Gastric
A549_EtOH_0.02pct_Lung_Carcinoma	CD4pp_CD25__IL17pp_PMA_Ionomcyin_stimulated_Th17_Primary_Cells
HSMM_Skeletal_Muscle_Myoblasts	Peripheral_Blood_Mononuclear_Primary_Cells
CD8_Naive_Primary_Cells	CD34_Primary_Cells
CD19_Primary_Cells_Cord_BI	Mobilized_CD34_Primary_Cells_Male
Left_Ventricle	CD4pp_CD25pp_CD127__Treg_Primary_Cells
Penis_Foreskin_Melanocyte_Primary_Cells_skin03	Mesenchymal_Stem_Cell_Derived_Adipocyte_Cultured_Cells
Adult_Liver	Small_Intestine
Rectal_Mucosa.Donor_31	Chondrocytes_from_Bone_Marrow_Derived_Mesenchymal_Stem_Cell_Cultured_Cells
Rectal_Mucosa.Donor_29	CD56_Primary_Cells
HUVEC_Umbilical_Vein_Endothelial_Cells	CD19_Primary_Cells_Cord_BI
IMR90_Cell_Line	Monocytes_CD14pp_RO01746
CD34_Cultured_Cells	Stomach_Smooth_Muscle
Right_Atrium	Mobilized_CD34_Primary_Cells_Female
CD3_Primary_Cells_Peripheral_UW	CD14_Primary_Cells
Brain_Angular_Gyrus	Duodenum_Mucosa
CD34_Primary_Cells	CD19_Primary_Cells_Peripheral_UW
NHLF_Lung_Fibroblasts	Adipose_Derived_Mesenchymal_Stem_Cell_Cultured_Cells
Fetal_Intestine_Large	Rectal_Mucosa.Donor_29
Brain_Cingulate_Gyrus	CD34_Cultured_Cells
Duodenum_Mucosa	Sigmoid_Colon
CD56_Primary_Cells	Fetal_Thymus
NHDF_Ad_Adult_Dermal_Fibroblasts	CD15_Primary_Cells
HSMMtube_Skeletal_Muscle_Myotubes_Derived_from_HSMM	Bone_Marrow_Derived_Mesenchymal_Stem_Cell_Cultured_Cells
H9_Derived_Neuronal_Progenitor_Cultured_Cells	Fetal_Intestine_Large
CD4pp_CD25__CD45RApp_Naive_Primary_Cells	Thymus
H9_Derived_Neuron_Cultured_Cells	Duodenum_Smooth_Muscle
Penis_Foreskin_Keratinocyte_Primary_Cells_skin03	Osteoblasts
Right_Ventricle	Muscle_Satellite_Cultured_Cells
Penis_Foreskin_Fibroblast_Primary_Cells_skin01	Rectal_Mucosa.Donor_31
Brain_Mid_Frontal_Lobe	Skeletal_Muscle_Male
NHEK_Epidermal_Keratinocytes	Penis_Foreskin_Keratinocyte_Primary_Cells_skin02
CD4pp_CD25int_CD127pp_Tmem_Primary_Cells	IMR90_Cell_Line
Brain_Inferior_Temporal_Lobe	Adipose_Nuclei
CD14_Primary_Cells	A549_EtOH_0.02pct_Lung_Carcinoma
Small_Intestine	Skeletal_Muscle_Female
Chondrocytes_from_Bone_Marrow_Derived_Mesenchymal_Stem_Cell_Cultured_Cells	Penis_Foreskin_Keratinocyte_Primary_Cells_skin03
Psoas_Muscle	HepG2_Hepatocellular_Carcinoma
Aorta	Dnd41_TCell_Leukemia
Mobilized_CD34_Primary_Cells_Male	Fetal_Intestine_Small
Fetal_Intestine_Small	Fetal_Muscle_Leg
Bone_Marrow_Derived_Mesenchymal_Stem_Cell_Cultured_Cells	HUVEC_Umbilical_Vein_Endothelial_Cells
CD8_Memory_Primary_Cells	Neurosphere_Cultured_Cells_Cortex_Derived
Fetal_Heart	Penis_Foreskin_Melanocyte_Primary_Cells_skin01
Brain_Substantia_Nigra	NHEK_Epidermal_Keratinocytes
CD15_Primary_Cells	NHDF_Ad_Adult_Dermal_Fibroblasts
HepG2_Hepatocellular_Carcinoma	Placenta_Amnion
Dnd41_TCell_Leukemia	H9_Derived_Neuron_Cultured_Cells
CD19_Primary_Cells_Peripheral_UW	Stomach_Mucosa
Breast_Myoepithelial_Cells	H1_Derived_Mesenchymal_Stem_Cells
Mesenchymal_Stem_Cell_Derived_Adipocyte_Cultured_Cells	Penis_Foreskin_Melanocyte_Primary_Cells_skin03
Rectal_Smooth_Muscle	HUES6_Cell_Line
Brain_Hippocampus_Middle	Brain_Hippocampus_Middle
Muscle_Satellite_Cultured_Cells	HSMM_Skeletal_Muscle_Myoblasts
Penis_Foreskin_Keratinocyte_Primary_Cells_skin02	Fetal_Brain_Male
HUES6_Cell_Line	Left_Ventricle
Brain_Anterior_Caudate	Fetal_Stomach
Breast_vHMEC	NH_A_Astrocytes
CD4_Memory_Primary_Cells	ES_I3_Cell_Line
Penis_Foreskin_Fibroblast_Primary_Cells_skin02	iPS_20b_Cell_Line
Neurosphere_Cultured_Cells_Ganglionic_Eminence_Derived	Rectal_Smooth_Muscle
H1_Derived_Mesenchymal_Stem_Cells	HeLa_S3_Cervical_Carcinoma
Mobilized_CD34_Primary_Cells_Female	Fetal_Muscle_Trunk
Fetal_Brain_Female	iPS_15b_Cell_Line
Neurosphere_Cultured_Cells_Cortex_Derived	Neurosphere_Cultured_Cells_Ganglionic_Eminence_Derived
Adipose_Derived_Mesenchymal_Stem_Cell_Cultured_Cells	Brain_Cingulate_Gyrus
CD4_Naive_Primary_Cells	ES_WA7_Cell_Line
Adipose_Nuclei	Fetal_Lung
Skeletal_Muscle_Female	HUES64_Cell_Line
hESC_Derived_CD56pp_Mesoderm_Cultured_Cells	Penis_Foreskin_Fibroblast_Primary_Cells_skin02
Thymus	Fetal_Heart
Monocytes_CD14pp_RO01746	Right_Atrium
hESC_Derived_CD184pp_Endoderm_Cultured_Cells	Colon_Smooth_Muscle
Brain_Germinal_Matrix	H9_Derived_Neuronal_Progenitor_Cultured_Cells
Osteoblasts	Colonic_Mucosa
Fetal_Muscle_Leg	Brain_Germinal_Matrix
Colonic_Mucosa	Brain_Mid_Frontal_Lobe
Fetal_Adrenal_Gland	Esophagus
Duodenum_Smooth_Muscle	iPS_DF_19.11_Cell_Line
Fetal_Placenta	Fetal_Brain_Female
Stomach_Smooth_Muscle	Ovary
NH_A_Astrocytes	Penis_Foreskin_Fibroblast_Primary_Cells_skin01
Placenta_Amnion	Right_Ventricle
Lung	Brain_Angular_Gyrus
Stomach_Mucosa	Brain_Substantia_Nigra
Fetal_Brain_Male	Brain_Inferior_Temporal_Lobe
Penis_Foreskin_Melanocyte_Primary_Cells_skin01	Lung
HUES64_Cell_Line	iPS_18_Cell_Line
ES_WA7_Cell_Line	HUES48_Cell_Line
Fetal_Kidney	NHLF_Lung_Fibroblasts
Esophagus	Fetal_Kidney
HUES48_Cell_Line	GM12878_Lymphoblastoid
Fetal_Lung	Aorta
Fetal_Stomach	Brain_Anterior_Caudate
Colon_Smooth_Muscle	hESC_Derived_CD56pp_Mesoderm_Cultured_Cells
Skeletal_Muscle_Male	hESC_Derived_CD184pp_Endoderm_Cultured_Cells
Fetal_Muscle_Trunk	Breast_Myoepithelial_Cells
iPS_20b_Cell_Line	H9_Cell_Line
Fetal_Thymus	hESC_Derived_CD56pp_Ectoderm_Cultured_Cells
iPS_18_Cell_Line	Fetal_Placenta
ES_I3_Cell_Line	H1_Cell_Line
4star	H1_BMP4_Derived_Mesendoderm_Cultured_Cells
iPS_15b_Cell_Line	H1_BMP4_Derived_Trophoblast_Cultured_Cells
iPS_DF_6.9_Cell_Line	Pancreatic_Islets
H1_Cell_Line	Adult_Liver
H9_Cell_Line	Psoas_Muscle
hESC_Derived_CD56pp_Ectoderm_Cultured_Cells	iPS_DF_6.9_Cell_Line
H1_BMP4_Derived_Trophoblast_Cultured_Cells	K562_Leukemia
H1_BMP4_Derived_Mesendoderm_Cultured_Cells	HMEC_Mammary_Epithelial
Pancreas	Spleen
H1_Derived_Neuronal_Progenitor_Cultured_Cells	4star
Gastric	Breast_vHMEC
Spleen	H1_Derived_Neuronal_Progenitor_Cultured_Cells
iPS_DF_19.11_Cell_Line	Pancreas
