(New) Cell Type	(Old) Cell Type
HUES64_Cell_Line	HUES64_Cell_Line
HUES48_Cell_Line	iPS_18_Cell_Line
iPS_20b_Cell_Line	HUES48_Cell_Line
Fetal_Heart	iPS_20b_Cell_Line
H1_BMP4_Derived_Mesendoderm_Cultured_Cells	HUES6_Cell_Line
iPS_15b_Cell_Line	iPS_15b_Cell_Line
Fetal_Kidney	ES_I3_Cell_Line
NHDF_Ad_Adult_Dermal_Fibroblasts	H1_Cell_Line
iPS_18_Cell_Line	H9_Cell_Line
Fetal_Brain_Male	hESC_Derived_CD56pp_Ectoderm_Cultured_Cells
hESC_Derived_CD184pp_Endoderm_Cultured_Cells	hESC_Derived_CD56pp_Mesoderm_Cultured_Cells
Fetal_Lung	H1_BMP4_Derived_Mesendoderm_Cultured_Cells
Pancreatic_Islets	H9_Derived_Neuronal_Progenitor_Cultured_Cells
Pancreas	Fetal_Kidney
HSMMtube_Skeletal_Muscle_Myotubes_Derived_from_HSMM	hESC_Derived_CD184pp_Endoderm_Cultured_Cells
Duodenum_Smooth_Muscle	ES_WA7_Cell_Line
Adipose_Derived_Mesenchymal_Stem_Cell_Cultured_Cells	Fetal_Stomach
HUES6_Cell_Line	H9_Derived_Neuron_Cultured_Cells
H9_Cell_Line	Fetal_Intestine_Large
Colon_Smooth_Muscle	Fetal_Intestine_Small
ES_I3_Cell_Line	iPS_DF_6.9_Cell_Line
Small_Intestine	Fetal_Adrenal_Gland
ES_WA7_Cell_Line	Duodenum_Smooth_Muscle
Gastric	Fetal_Brain_Female
hESC_Derived_CD56pp_Ectoderm_Cultured_Cells	Brain_Germinal_Matrix
Brain_Angular_Gyrus	Fetal_Lung
NHLF_Lung_Fibroblasts	Neurosphere_Cultured_Cells_Cortex_Derived
Mesenchymal_Stem_Cell_Derived_Adipocyte_Cultured_Cells	Fetal_Muscle_Leg
iPS_DF_6.9_Cell_Line	Breast_vHMEC
Aorta	4star
Brain_Anterior_Caudate	Neurosphere_Cultured_Cells_Ganglionic_Eminence_Derived
Brain_Substantia_Nigra	Fetal_Brain_Male
CD8_Memory_Primary_Cells	NHLF_Lung_Fibroblasts
Psoas_Muscle	Penis_Foreskin_Keratinocyte_Primary_Cells_skin03
A549_EtOH_0.02pct_Lung_Carcinoma	Fetal_Thymus
Rectal_Smooth_Muscle	Penis_Foreskin_Melanocyte_Primary_Cells_skin03
Brain_Inferior_Temporal_Lobe	IMR90_Cell_Line
Ovary	Breast_Myoepithelial_Cells
Fetal_Brain_Female	NH_A_Astrocytes
Rectal_Mucosa.Donor_29	Thymus
H1_Derived_Neuronal_Progenitor_Cultured_Cells	Penis_Foreskin_Keratinocyte_Primary_Cells_skin02
Right_Atrium	Colon_Smooth_Muscle
Brain_Cingulate_Gyrus	NHDF_Ad_Adult_Dermal_Fibroblasts
Breast_vHMEC	Rectal_Smooth_Muscle
Osteoblasts	HMEC_Mammary_Epithelial
CD4_Memory_Primary_Cells	Brain_Mid_Frontal_Lobe
CD4_Naive_Primary_Cells	Brain_Angular_Gyrus
HSMM_Skeletal_Muscle_Myoblasts	Fetal_Muscle_Trunk
Fetal_Stomach	Stomach_Mucosa
HeLa_S3_Cervical_Carcinoma	HSMM_Skeletal_Muscle_Myoblasts
Brain_Mid_Frontal_Lobe	Psoas_Muscle
Brain_Hippocampus_Middle	Brain_Anterior_Caudate
Fetal_Intestine_Small	Pancreatic_Islets
H9_Derived_Neuronal_Progenitor_Cultured_Cells	Brain_Cingulate_Gyrus
K562_Leukemia	NHEK_Epidermal_Keratinocytes
NH_A_Astrocytes	Brain_Hippocampus_Middle
Fetal_Intestine_Large	Small_Intestine
CD34_Primary_Cells	Rectal_Mucosa.Donor_29
Thymus	Rectal_Mucosa.Donor_31
Bone_Marrow_Derived_Mesenchymal_Stem_Cell_Cultured_Cells	Duodenum_Mucosa
Duodenum_Mucosa	HUVEC_Umbilical_Vein_Endothelial_Cells
CD4pp_CD25__CD45ROpp_Memory_Primary_Cells	H1_Derived_Neuronal_Progenitor_Cultured_Cells
Muscle_Satellite_Cultured_Cells	Right_Atrium
H1_Cell_Line	Brain_Substantia_Nigra
HepG2_Hepatocellular_Carcinoma	Osteoblasts
Chondrocytes_from_Bone_Marrow_Derived_Mesenchymal_Stem_Cell_Cultured_Cells	Adipose_Derived_Mesenchymal_Stem_Cell_Cultured_Cells
CD3_Primary_Cells_Cord_BI	HepG2_Hepatocellular_Carcinoma
Neurosphere_Cultured_Cells_Ganglionic_Eminence_Derived	Penis_Foreskin_Melanocyte_Primary_Cells_skin01
Rectal_Mucosa.Donor_31	Brain_Inferior_Temporal_Lobe
GM12878_Lymphoblastoid	CD34_Cultured_Cells
hESC_Derived_CD56pp_Mesoderm_Cultured_Cells	Adipose_Nuclei
Sigmoid_Colon	Left_Ventricle
CD4pp_CD25int_CD127pp_Tmem_Primary_Cells	HSMMtube_Skeletal_Muscle_Myotubes_Derived_from_HSMM
Stomach_Smooth_Muscle	Fetal_Placenta
Brain_Germinal_Matrix	Muscle_Satellite_Cultured_Cells
CD19_Primary_Cells_Cord_BI	Dnd41_TCell_Leukemia
Neurosphere_Cultured_Cells_Cortex_Derived	CD14_Primary_Cells
NHEK_Epidermal_Keratinocytes	A549_EtOH_0.02pct_Lung_Carcinoma
Peripheral_Blood_Mononuclear_Primary_Cells	Sigmoid_Colon
CD4pp_CD25__IL17pp_PMA_Ionomcyin_stimulated_Th17_Primary_Cells	H1_BMP4_Derived_Trophoblast_Cultured_Cells
IMR90_Cell_Line	CD19_Primary_Cells_Peripheral_UW
CD8_Naive_Primary_Cells	Colonic_Mucosa
Adult_Liver	Chondrocytes_from_Bone_Marrow_Derived_Mesenchymal_Stem_Cell_Cultured_Cells
4star	Bone_Marrow_Derived_Mesenchymal_Stem_Cell_Cultured_Cells
Penis_Foreskin_Keratinocyte_Primary_Cells_skin02	Penis_Foreskin_Fibroblast_Primary_Cells_skin01
Breast_Myoepithelial_Cells	CD4pp_CD25pp_CD127__Treg_Primary_Cells
Fetal_Adrenal_Gland	CD34_Primary_Cells
Stomach_Mucosa	iPS_DF_19.11_Cell_Line
H9_Derived_Neuron_Cultured_Cells	Fetal_Heart
Left_Ventricle	HeLa_S3_Cervical_Carcinoma
Skeletal_Muscle_Female	Peripheral_Blood_Mononuclear_Primary_Cells
Penis_Foreskin_Melanocyte_Primary_Cells_skin03	CD8_Memory_Primary_Cells
Placenta_Amnion	Penis_Foreskin_Fibroblast_Primary_Cells_skin02
CD4pp_CD25__CD45RApp_Naive_Primary_Cells	CD19_Primary_Cells_Cord_BI
Penis_Foreskin_Fibroblast_Primary_Cells_skin01	CD3_Primary_Cells_Cord_BI
Penis_Foreskin_Keratinocyte_Primary_Cells_skin03	CD3_Primary_Cells_Peripheral_UW
HUVEC_Umbilical_Vein_Endothelial_Cells	Skeletal_Muscle_Male
Fetal_Muscle_Leg	Skeletal_Muscle_Female
Esophagus	Mobilized_CD34_Primary_Cells_Female
Adipose_Nuclei	Placenta_Amnion
H1_BMP4_Derived_Trophoblast_Cultured_Cells	CD8_Naive_Primary_Cells
Mobilized_CD34_Primary_Cells_Male	CD4pp_CD25__IL17pp_PMA_Ionomcyin_stimulated_Th17_Primary_Cells
Penis_Foreskin_Fibroblast_Primary_Cells_skin02	Stomach_Smooth_Muscle
Skeletal_Muscle_Male	CD56_Primary_Cells
CD14_Primary_Cells	K562_Leukemia
iPS_DF_19.11_Cell_Line	CD4pp_CD25__Th_Primary_Cells
Fetal_Thymus	CD4pp_CD25__CD45RApp_Naive_Primary_Cells
HMEC_Mammary_Epithelial	Right_Ventricle
Colonic_Mucosa	CD4pp_CD25__IL17__PMA_Ionomycin_stimulated_MACS_purified_Th_Primary_Cells
Fetal_Muscle_Trunk	CD4pp_CD25int_CD127pp_Tmem_Primary_Cells
Mobilized_CD34_Primary_Cells_Female	CD4_Naive_Primary_Cells
Monocytes_CD14pp_RO01746	Aorta
Lung	CD4_Memory_Primary_Cells
CD4pp_CD25pp_CD127__Treg_Primary_Cells	CD15_Primary_Cells
Fetal_Placenta	Monocytes_CD14pp_RO01746
Dnd41_TCell_Leukemia	Esophagus
Penis_Foreskin_Melanocyte_Primary_Cells_skin01	GM12878_Lymphoblastoid
H1_Derived_Mesenchymal_Stem_Cells	Ovary
Right_Ventricle	CD4pp_CD25__CD45ROpp_Memory_Primary_Cells
CD19_Primary_Cells_Peripheral_UW	H1_Derived_Mesenchymal_Stem_Cells
CD34_Cultured_Cells	Adult_Liver
CD4pp_CD25__IL17__PMA_Ionomycin_stimulated_MACS_purified_Th_Primary_Cells	Mesenchymal_Stem_Cell_Derived_Adipocyte_Cultured_Cells
CD3_Primary_Cells_Peripheral_UW	Mobilized_CD34_Primary_Cells_Male
CD56_Primary_Cells	Lung
CD4pp_CD25__Th_Primary_Cells	Pancreas
Spleen	Gastric
CD15_Primary_Cells	Spleen
