(New) Cell Type	(Old) Cell Type
Mesenchymal_Stem_Cell_Derived_Adipocyte_Cultured_Cells	Mesenchymal_Stem_Cell_Derived_Adipocyte_Cultured_Cells
HSMMtube_Skeletal_Muscle_Myotubes_Derived_from_HSMM	Adipose_Derived_Mesenchymal_Stem_Cell_Cultured_Cells
A549_EtOH_0.02pct_Lung_Carcinoma	Colon_Smooth_Muscle
Fetal_Brain_Female	Bone_Marrow_Derived_Mesenchymal_Stem_Cell_Cultured_Cells
CD19_Primary_Cells_Cord_BI	Brain_Substantia_Nigra
Osteoblasts	Chondrocytes_from_Bone_Marrow_Derived_Mesenchymal_Stem_Cell_Cultured_Cells
HSMM_Skeletal_Muscle_Myoblasts	HSMM_Skeletal_Muscle_Myoblasts
K562_Leukemia	Brain_Anterior_Caudate
CD3_Primary_Cells_Cord_BI	Brain_Angular_Gyrus
Gastric	NHLF_Lung_Fibroblasts
Stomach_Mucosa	Muscle_Satellite_Cultured_Cells
Dnd41_TCell_Leukemia	Rectal_Smooth_Muscle
HUES48_Cell_Line	HSMMtube_Skeletal_Muscle_Myotubes_Derived_from_HSMM
Chondrocytes_from_Bone_Marrow_Derived_Mesenchymal_Stem_Cell_Cultured_Cells	Ovary
Fetal_Heart	Adipose_Nuclei
NHDF_Ad_Adult_Dermal_Fibroblasts	Brain_Mid_Frontal_Lobe
Bone_Marrow_Derived_Mesenchymal_Stem_Cell_Cultured_Cells	Brain_Cingulate_Gyrus
4star	Duodenum_Smooth_Muscle
Adult_Liver	NH_A_Astrocytes
Adipose_Derived_Mesenchymal_Stem_Cell_Cultured_Cells	Brain_Inferior_Temporal_Lobe
iPS_20b_Cell_Line	Osteoblasts
Fetal_Lung	hESC_Derived_CD56pp_Mesoderm_Cultured_Cells
HUVEC_Umbilical_Vein_Endothelial_Cells	Brain_Hippocampus_Middle
NHLF_Lung_Fibroblasts	Psoas_Muscle
Psoas_Muscle	NHDF_Ad_Adult_Dermal_Fibroblasts
Rectal_Smooth_Muscle	Rectal_Mucosa.Donor_29
Right_Atrium	Rectal_Mucosa.Donor_31
HUES64_Cell_Line	A549_EtOH_0.02pct_Lung_Carcinoma
H1_Cell_Line	Esophagus
iPS_15b_Cell_Line	Left_Ventricle
Fetal_Brain_Male	HMEC_Mammary_Epithelial
H1_BMP4_Derived_Mesendoderm_Cultured_Cells	Stomach_Smooth_Muscle
GM12878_Lymphoblastoid	Neurosphere_Cultured_Cells_Ganglionic_Eminence_Derived
hESC_Derived_CD184pp_Endoderm_Cultured_Cells	NHEK_Epidermal_Keratinocytes
Ovary	Skeletal_Muscle_Female
ES_WA7_Cell_Line	CD4_Naive_Primary_Cells
Brain_Substantia_Nigra	Duodenum_Mucosa
H9_Cell_Line	H1_Derived_Neuronal_Progenitor_Cultured_Cells
Brain_Anterior_Caudate	Adult_Liver
hESC_Derived_CD56pp_Mesoderm_Cultured_Cells	CD4pp_CD25int_CD127pp_Tmem_Primary_Cells
iPS_DF_6.9_Cell_Line	Right_Ventricle
H1_Derived_Neuronal_Progenitor_Cultured_Cells	Colonic_Mucosa
iPS_18_Cell_Line	Placenta_Amnion
Brain_Angular_Gyrus	IMR90_Cell_Line
Thymus	Fetal_Heart
Neurosphere_Cultured_Cells_Ganglionic_Eminence_Derived	CD8_Memory_Primary_Cells
NH_A_Astrocytes	CD4_Memory_Primary_Cells
CD34_Primary_Cells	Breast_Myoepithelial_Cells
hESC_Derived_CD56pp_Ectoderm_Cultured_Cells	Skeletal_Muscle_Male
Muscle_Satellite_Cultured_Cells	Penis_Foreskin_Melanocyte_Primary_Cells_skin01
Sigmoid_Colon	CD4pp_CD25__CD45RApp_Naive_Primary_Cells
HeLa_S3_Cervical_Carcinoma	Penis_Foreskin_Keratinocyte_Primary_Cells_skin02
NHEK_Epidermal_Keratinocytes	Penis_Foreskin_Melanocyte_Primary_Cells_skin03
Brain_Mid_Frontal_Lobe	H1_Derived_Mesenchymal_Stem_Cells
CD8_Memory_Primary_Cells	CD4pp_CD25__IL17pp_PMA_Ionomcyin_stimulated_Th17_Primary_Cells
Colon_Smooth_Muscle	Penis_Foreskin_Fibroblast_Primary_Cells_skin01
Brain_Cingulate_Gyrus	iPS_DF_6.9_Cell_Line
Fetal_Intestine_Large	Spleen
HUES6_Cell_Line	HUVEC_Umbilical_Vein_Endothelial_Cells
Brain_Inferior_Temporal_Lobe	H1_BMP4_Derived_Trophoblast_Cultured_Cells
Breast_vHMEC	CD8_Naive_Primary_Cells
CD4_Naive_Primary_Cells	Fetal_Intestine_Small
IMR90_Cell_Line	CD34_Primary_Cells
Brain_Germinal_Matrix	iPS_DF_19.11_Cell_Line
Duodenum_Mucosa	Penis_Foreskin_Keratinocyte_Primary_Cells_skin03
CD4_Memory_Primary_Cells	Fetal_Intestine_Large
Left_Ventricle	CD3_Primary_Cells_Cord_BI
Aorta	Penis_Foreskin_Fibroblast_Primary_Cells_skin02
Pancreas	H9_Cell_Line
Fetal_Intestine_Small	Peripheral_Blood_Mononuclear_Primary_Cells
Rectal_Mucosa.Donor_31	Stomach_Mucosa
Rectal_Mucosa.Donor_29	Neurosphere_Cultured_Cells_Cortex_Derived
Fetal_Kidney	Fetal_Lung
ES_I3_Cell_Line	Fetal_Brain_Female
Placenta_Amnion	4star
Small_Intestine	Sigmoid_Colon
Duodenum_Smooth_Muscle	Fetal_Kidney
Stomach_Smooth_Muscle	hESC_Derived_CD184pp_Endoderm_Cultured_Cells
H1_BMP4_Derived_Trophoblast_Cultured_Cells	Lung
Fetal_Stomach	CD34_Cultured_Cells
Penis_Foreskin_Fibroblast_Primary_Cells_skin02	H9_Derived_Neuronal_Progenitor_Cultured_Cells
H9_Derived_Neuronal_Progenitor_Cultured_Cells	Brain_Germinal_Matrix
iPS_DF_19.11_Cell_Line	H9_Derived_Neuron_Cultured_Cells
Brain_Hippocampus_Middle	CD4pp_CD25__Th_Primary_Cells
Monocytes_CD14pp_RO01746	ES_WA7_Cell_Line
HepG2_Hepatocellular_Carcinoma	CD4pp_CD25__IL17__PMA_Ionomycin_stimulated_MACS_purified_Th_Primary_Cells
Peripheral_Blood_Mononuclear_Primary_Cells	Breast_vHMEC
Penis_Foreskin_Melanocyte_Primary_Cells_skin01	CD4pp_CD25__CD45ROpp_Memory_Primary_Cells
CD4pp_CD25__IL17pp_PMA_Ionomcyin_stimulated_Th17_Primary_Cells	Small_Intestine
H1_Derived_Mesenchymal_Stem_Cells	CD4pp_CD25pp_CD127__Treg_Primary_Cells
Neurosphere_Cultured_Cells_Cortex_Derived	GM12878_Lymphoblastoid
Mobilized_CD34_Primary_Cells_Male	hESC_Derived_CD56pp_Ectoderm_Cultured_Cells
Esophagus	H1_Cell_Line
CD4pp_CD25int_CD127pp_Tmem_Primary_Cells	Mobilized_CD34_Primary_Cells_Female
CD4pp_CD25__CD45RApp_Naive_Primary_Cells	Fetal_Stomach
Skeletal_Muscle_Female	Thymus
Penis_Foreskin_Keratinocyte_Primary_Cells_skin02	HUES6_Cell_Line
Right_Ventricle	CD19_Primary_Cells_Cord_BI
Breast_Myoepithelial_Cells	ES_I3_Cell_Line
Penis_Foreskin_Melanocyte_Primary_Cells_skin03	Fetal_Placenta
CD4pp_CD25pp_CD127__Treg_Primary_Cells	Fetal_Muscle_Leg
Adipose_Nuclei	HUES48_Cell_Line
Lung	Mobilized_CD34_Primary_Cells_Male
CD8_Naive_Primary_Cells	H1_BMP4_Derived_Mesendoderm_Cultured_Cells
Colonic_Mucosa	Fetal_Brain_Male
Pancreatic_Islets	CD19_Primary_Cells_Peripheral_UW
CD15_Primary_Cells	iPS_18_Cell_Line
Penis_Foreskin_Fibroblast_Primary_Cells_skin01	iPS_15b_Cell_Line
Spleen	HUES64_Cell_Line
CD4pp_CD25__CD45ROpp_Memory_Primary_Cells	Fetal_Thymus
Fetal_Placenta	iPS_20b_Cell_Line
H9_Derived_Neuron_Cultured_Cells	CD56_Primary_Cells
Skeletal_Muscle_Male	CD15_Primary_Cells
Penis_Foreskin_Keratinocyte_Primary_Cells_skin03	Fetal_Adrenal_Gland
CD34_Cultured_Cells	Fetal_Muscle_Trunk
Fetal_Muscle_Trunk	Monocytes_CD14pp_RO01746
Mobilized_CD34_Primary_Cells_Female	Right_Atrium
Fetal_Thymus	Pancreatic_Islets
CD56_Primary_Cells	HepG2_Hepatocellular_Carcinoma
Fetal_Muscle_Leg	CD14_Primary_Cells
Fetal_Adrenal_Gland	CD3_Primary_Cells_Peripheral_UW
CD14_Primary_Cells	Aorta
HMEC_Mammary_Epithelial	K562_Leukemia
CD4pp_CD25__IL17__PMA_Ionomycin_stimulated_MACS_purified_Th_Primary_Cells	Gastric
CD3_Primary_Cells_Peripheral_UW	Dnd41_TCell_Leukemia
CD19_Primary_Cells_Peripheral_UW	HeLa_S3_Cervical_Carcinoma
CD4pp_CD25__Th_Primary_Cells	Pancreas
