Embedding-based	Giggle-legacy
iPS_18_Cell_Line_Weak_Repressed_PolyComb	iPS_18_Cell_Line_Weak_Repressed_PolyComb
H1_Cell_Line_Weak_Repressed_PolyComb	iPS_18_Cell_Line_Repressed_PolyComb
H1_Derived_Neuronal_Progenitor_Cultured_Cells_Weak_Repressed_PolyComb	iPS_20b_Cell_Line_Weak_Repressed_PolyComb
hESC_Derived_CD56pp_Ectoderm_Cultured_Cells_Weak_Repressed_PolyComb	HUES64_Cell_Line_Weak_Repressed_PolyComb
H9_Cell_Line_Weak_Repressed_PolyComb	HUES48_Cell_Line_Weak_Repressed_PolyComb
HUES64_Cell_Line_Weak_Repressed_PolyComb	H1_Cell_Line_Weak_Repressed_PolyComb
iPS_DF_19.11_Cell_Line_Weak_Repressed_PolyComb	iPS_15b_Cell_Line_Weak_Repressed_PolyComb
iPS_20b_Cell_Line_Weak_Repressed_PolyComb	hESC_Derived_CD56pp_Ectoderm_Cultured_Cells_Weak_Repressed_PolyComb
Chondrocytes_from_Bone_Marrow_Derived_Mesenchymal_Stem_Cell_Cultured_Cells_Weak_transcription	iPS_15b_Cell_Line_Repressed_PolyComb
iPS_DF_6.9_Cell_Line_Weak_Repressed_PolyComb	ES_I3_Cell_Line_Weak_Repressed_PolyComb
Bone_Marrow_Derived_Mesenchymal_Stem_Cell_Cultured_Cells_Weak_transcription	HUES6_Cell_Line_Weak_Repressed_PolyComb
Osteoblasts_Weak_transcription	iPS_20b_Cell_Line_Repressed_PolyComb
Mesenchymal_Stem_Cell_Derived_Adipocyte_Cultured_Cells_Weak_transcription	HUES64_Cell_Line_Repressed_PolyComb
CD15_Primary_Cells_Weak_transcription	H1_BMP4_Derived_Mesendoderm_Cultured_Cells_Weak_Repressed_PolyComb
Monocytes_CD14pp_RO01746_Weak_transcription	ES_WA7_Cell_Line_Weak_Repressed_PolyComb
Mobilized_CD34_Primary_Cells_Female_Weak_transcription	HUES6_Cell_Line_Repressed_PolyComb
iPS_15b_Cell_Line_Weak_Repressed_PolyComb	iPS_DF_6.9_Cell_Line_Weak_Repressed_PolyComb
HUES64_Cell_Line_Weak_transcription	H9_Cell_Line_Weak_Repressed_PolyComb
Adipose_Derived_Mesenchymal_Stem_Cell_Cultured_Cells_Weak_transcription	hESC_Derived_CD56pp_Ectoderm_Cultured_Cells_Repressed_PolyComb
CD14_Primary_Cells_Weak_transcription	Fetal_Thymus_Weak_Repressed_PolyComb
HepG2_Hepatocellular_Carcinoma_Weak_transcription	HUES48_Cell_Line_Repressed_PolyComb
HUES48_Cell_Line_Weak_Repressed_PolyComb	Placenta_Amnion_Weak_Repressed_PolyComb
CD4pp_CD25__IL17pp_PMA_Ionomcyin_stimulated_Th17_Primary_Cells_Strong_transcription	hESC_Derived_CD56pp_Mesoderm_Cultured_Cells_Weak_Repressed_PolyComb
Adipose_Nuclei_Weak_transcription	Thymus_Weak_Repressed_PolyComb
iPS_18_Cell_Line_Weak_transcription	H1_BMP4_Derived_Trophoblast_Cultured_Cells_Weak_Repressed_PolyComb
HUES48_Cell_Line_Weak_transcription	ES_I3_Cell_Line_Repressed_PolyComb
H1_BMP4_Derived_Trophoblast_Cultured_Cells_Weak_Repressed_PolyComb	CD15_Primary_Cells_Repressed_PolyComb
HUES6_Cell_Line_Weak_transcription	hESC_Derived_CD184pp_Endoderm_Cultured_Cells_Weak_Repressed_PolyComb
Fetal_Adrenal_Gland_Strong_transcription	iPS_DF_19.11_Cell_Line_Weak_Repressed_PolyComb
Mobilized_CD34_Primary_Cells_Male_Weak_transcription	Monocytes_CD14pp_RO01746_Repressed_PolyComb
H9_Derived_Neuronal_Progenitor_Cultured_Cells_Weak_transcription	H9_Derived_Neuronal_Progenitor_Cultured_Cells_Repressed_PolyComb
Mesenchymal_Stem_Cell_Derived_Adipocyte_Cultured_Cells_Strong_transcription	Duodenum_Smooth_Muscle_Weak_Repressed_PolyComb
Penis_Foreskin_Keratinocyte_Primary_Cells_skin02_Strong_transcription	CD14_Primary_Cells_Repressed_PolyComb
H9_Derived_Neuron_Cultured_Cells_Weak_transcription	CD15_Primary_Cells_Weak_Repressed_PolyComb
Fetal_Lung_Weak_transcription	Stomach_Mucosa_Weak_Repressed_PolyComb
Stomach_Smooth_Muscle_Strong_transcription	Fetal_Intestine_Large_Repressed_PolyComb
iPS_20b_Cell_Line_Weak_transcription	Colon_Smooth_Muscle_Weak_Repressed_PolyComb
Adult_Liver_Weak_transcription	CD3_Primary_Cells_Cord_BI_Repressed_PolyComb
Penis_Foreskin_Fibroblast_Primary_Cells_skin01_Heterochromatin	Colonic_Mucosa_Weak_Repressed_PolyComb
Mobilized_CD34_Primary_Cells_Male_Repressed_PolyComb	Fetal_Thymus_Repressed_PolyComb
Neurosphere_Cultured_Cells_Ganglionic_Eminence_Derived_Strong_transcription	Brain_Germinal_Matrix_Weak_Repressed_PolyComb
Muscle_Satellite_Cultured_Cells_Weak_transcription	H1_Cell_Line_Repressed_PolyComb
ES_I3_Cell_Line_Weak_Repressed_PolyComb	ES_WA7_Cell_Line_Repressed_PolyComb
Penis_Foreskin_Fibroblast_Primary_Cells_skin02_Heterochromatin	H9_Derived_Neuron_Cultured_Cells_Repressed_PolyComb
hESC_Derived_CD56pp_Ectoderm_Cultured_Cells_Strong_transcription	Rectal_Smooth_Muscle_Weak_Repressed_PolyComb
CD19_Primary_Cells_Peripheral_UW_Weak_transcription	Fetal_Intestine_Small_Repressed_PolyComb
Fetal_Muscle_Leg_Strong_transcription	Fetal_Brain_Male_Repressed_PolyComb
K562_Leukemia_Weak_transcription	Fetal_Brain_Female_Repressed_PolyComb
Neurosphere_Cultured_Cells_Cortex_Derived_Strong_transcription	Brain_Germinal_Matrix_Repressed_PolyComb
Fetal_Brain_Female_Strong_transcription	CD14_Primary_Cells_Weak_Repressed_PolyComb
NHDF_Ad_Adult_Dermal_Fibroblasts_Weak_transcription	Rectal_Mucosa.Donor_29_Weak_Repressed_PolyComb
Skeletal_Muscle_Male_Strong_transcription	Fetal_Intestine_Small_Weak_Repressed_PolyComb
Skeletal_Muscle_Female_Strong_transcription	Fetal_Muscle_Leg_Repressed_PolyComb
H1_BMP4_Derived_Mesendoderm_Cultured_Cells_Weak_Repressed_PolyComb	Duodenum_Mucosa_Weak_Repressed_PolyComb
HMEC_Mammary_Epithelial_Weak_transcription	Rectal_Mucosa.Donor_31_Weak_Repressed_PolyComb
Fetal_Muscle_Trunk_Strong_transcription	Fetal_Stomach_Repressed_PolyComb
Neurosphere_Cultured_Cells_Ganglionic_Eminence_Derived_Weak_transcription	Fetal_Heart_Weak_Repressed_PolyComb
NHEK_Epidermal_Keratinocytes_Weak_transcription	Mobilized_CD34_Primary_Cells_Female_Repressed_PolyComb
Duodenum_Mucosa_Weak_transcription	Thymus_Repressed_PolyComb
Duodenum_Smooth_Muscle_Strong_transcription	CD8_Memory_Primary_Cells_Weak_Repressed_PolyComb
Adipose_Nuclei_Strong_transcription	Fetal_Heart_Repressed_PolyComb
CD14_Primary_Cells_Heterochromatin	NH_A_Astrocytes_Weak_Repressed_PolyComb
NH_A_Astrocytes_Weak_transcription	Mobilized_CD34_Primary_Cells_Male_Repressed_PolyComb
Fetal_Thymus_Weak_Repressed_PolyComb	Peripheral_Blood_Mononuclear_Primary_Cells_Weak_Repressed_PolyComb
Brain_Germinal_Matrix_Strong_transcription	hESC_Derived_CD184pp_Endoderm_Cultured_Cells_Repressed_PolyComb
Neurosphere_Cultured_Cells_Cortex_Derived_Weak_transcription	Fetal_Kidney_Weak_Repressed_PolyComb
H1_Cell_Line_Strong_transcription	CD19_Primary_Cells_Peripheral_UW_Weak_Repressed_PolyComb
H1_Cell_Line_Weak_transcription	CD4pp_CD25__CD45RApp_Naive_Primary_Cells_Weak_Repressed_PolyComb
CD4pp_CD25int_CD127pp_Tmem_Primary_Cells_Strong_transcription	CD4pp_CD25pp_CD127__Treg_Primary_Cells_Weak_Repressed_PolyComb
4star_Weak_transcription	Fetal_Brain_Female_Weak_Repressed_PolyComb
HSMM_Skeletal_Muscle_Myoblasts_Weak_transcription	H9_Derived_Neuronal_Progenitor_Cultured_Cells_Weak_Repressed_PolyComb
A549_EtOH_0.02pct_Lung_Carcinoma_Weak_transcription	Neurosphere_Cultured_Cells_Cortex_Derived_Repressed_PolyComb
Osteoblasts_Strong_transcription	CD4pp_CD25int_CD127pp_Tmem_Primary_Cells_Weak_Repressed_PolyComb
Penis_Foreskin_Keratinocyte_Primary_Cells_skin03_Weak_transcription	Skeletal_Muscle_Female_Repressed_PolyComb
IMR90_Cell_Line_Heterochromatin	Fetal_Lung_Repressed_PolyComb
HUES6_Cell_Line_Heterochromatin	CD34_Primary_Cells_Repressed_PolyComb
CD56_Primary_Cells_Weak_transcription	Monocytes_CD14pp_RO01746_Weak_Repressed_PolyComb
Penis_Foreskin_Keratinocyte_Primary_Cells_skin02_Weak_transcription	Skeletal_Muscle_Female_Weak_Repressed_PolyComb
Penis_Foreskin_Melanocyte_Primary_Cells_skin03_Strong_transcription	Fetal_Intestine_Large_Weak_Repressed_PolyComb
CD34_Cultured_Cells_Weak_transcription	Neurosphere_Cultured_Cells_Ganglionic_Eminence_Derived_Weak_Repressed_PolyComb
Brain_Anterior_Caudate_Weak_transcription	CD34_Cultured_Cells_Weak_Repressed_PolyComb
GM12878_Lymphoblastoid_Weak_transcription	CD4_Naive_Primary_Cells_Weak_Repressed_PolyComb
Spleen_Weak_Repressed_PolyComb	Skeletal_Muscle_Male_Repressed_PolyComb
Fetal_Thymus_Weak_transcription	Duodenum_Smooth_Muscle_Repressed_PolyComb
hESC_Derived_CD184pp_Endoderm_Cultured_Cells_Weak_transcription	Fetal_Brain_Male_Weak_Repressed_PolyComb
Fetal_Placenta_Weak_transcription	Fetal_Muscle_Trunk_Weak_Repressed_PolyComb
Skeletal_Muscle_Male_Weak_transcription	CD19_Primary_Cells_Cord_BI_Repressed_PolyComb
Adipose_Derived_Mesenchymal_Stem_Cell_Cultured_Cells_Strong_transcription	Neurosphere_Cultured_Cells_Ganglionic_Eminence_Derived_Repressed_PolyComb
Brain_Hippocampus_Middle_Weak_transcription	NH_A_Astrocytes_Repressed_PolyComb
Gastric_Weak_Repressed_PolyComb	Fetal_Muscle_Leg_Weak_Repressed_PolyComb
CD19_Primary_Cells_Cord_BI_Weak_transcription	Penis_Foreskin_Keratinocyte_Primary_Cells_skin03_Repressed_PolyComb
Fetal_Adrenal_Gland_Weak_transcription	Fetal_Stomach_Weak_Repressed_PolyComb
Monocytes_CD14pp_RO01746_Repressed_PolyComb	CD4pp_CD25pp_CD127__Treg_Primary_Cells_Repressed_PolyComb
CD4pp_CD25__Th_Primary_Cells_Weak_transcription	Penis_Foreskin_Keratinocyte_Primary_Cells_skin02_Repressed_PolyComb
Muscle_Satellite_Cultured_Cells_Strong_transcription	Duodenum_Mucosa_Repressed_PolyComb
CD4pp_CD25__CD45RApp_Naive_Primary_Cells_Strong_transcription	Fetal_Lung_Weak_Repressed_PolyComb
Skeletal_Muscle_Female_Weak_transcription	CD4pp_CD25__IL17pp_PMA_Ionomcyin_stimulated_Th17_Primary_Cells_Weak_Repressed_PolyComb
CD4pp_CD25__IL17__PMA_Ionomycin_stimulated_MACS_purified_Th_Primary_Cells_Weak_transcription	Fetal_Muscle_Trunk_Repressed_PolyComb
Brain_Substantia_Nigra_Weak_transcription	Adipose_Derived_Mesenchymal_Stem_Cell_Cultured_Cells_Repressed_PolyComb
CD3_Primary_Cells_Cord_BI_Strong_transcription	CD4_Memory_Primary_Cells_Weak_Repressed_PolyComb
CD4pp_CD25pp_CD127__Treg_Primary_Cells_Weak_transcription	CD3_Primary_Cells_Cord_BI_Weak_Repressed_PolyComb
HMEC_Mammary_Epithelial_Heterochromatin	Skeletal_Muscle_Male_Weak_Repressed_PolyComb
IMR90_Cell_Line_Strong_transcription	CD4pp_CD25__IL17__PMA_Ionomycin_stimulated_MACS_purified_Th_Primary_Cells_Repressed_PolyComb
Rectal_Mucosa.Donor_31_Weak_transcription	H1_Derived_Mesenchymal_Stem_Cells_Repressed_PolyComb
Brain_Hippocampus_Middle_Strong_transcription	Fetal_Placenta_Weak_Repressed_PolyComb
Fetal_Intestine_Large_Strong_transcription	CD4pp_CD25__Th_Primary_Cells_Repressed_PolyComb
Fetal_Muscle_Leg_Weak_transcription	CD34_Cultured_Cells_Repressed_PolyComb
Bone_Marrow_Derived_Mesenchymal_Stem_Cell_Cultured_Cells_Strong_transcription	Stomach_Smooth_Muscle_Repressed_PolyComb
Breast_Myoepithelial_Cells_Weak_transcription	Psoas_Muscle_Weak_Repressed_PolyComb
CD3_Primary_Cells_Cord_BI_Weak_transcription	NHLF_Lung_Fibroblasts_Weak_Repressed_PolyComb
Thymus_Strong_transcription	Spleen_Weak_Repressed_PolyComb
Penis_Foreskin_Melanocyte_Primary_Cells_skin03_Weak_transcription	CD19_Primary_Cells_Cord_BI_Weak_Repressed_PolyComb
iPS_15b_Cell_Line_Weak_transcription	NHEK_Epidermal_Keratinocytes_Weak_Repressed_PolyComb
Fetal_Intestine_Large_Weak_transcription	Penis_Foreskin_Fibroblast_Primary_Cells_skin01_Repressed_PolyComb
Rectal_Mucosa.Donor_31_Strong_transcription	Penis_Foreskin_Fibroblast_Primary_Cells_skin02_Repressed_PolyComb
Penis_Foreskin_Fibroblast_Primary_Cells_skin01_Strong_transcription	Brain_Substantia_Nigra_Weak_Repressed_PolyComb
4star_Weak_Repressed_PolyComb	Stomach_Mucosa_Repressed_PolyComb
Dnd41_TCell_Leukemia_Weak_transcription	CD56_Primary_Cells_Weak_Repressed_PolyComb
HepG2_Hepatocellular_Carcinoma_Strong_transcription	H1_Derived_Mesenchymal_Stem_Cells_Weak_Repressed_PolyComb
Brain_Inferior_Temporal_Lobe_Weak_transcription	iPS_15b_Cell_Line_Bivalent_Enhancer
Duodenum_Smooth_Muscle_Weak_transcription	H9_Derived_Neuron_Cultured_Cells_Weak_Repressed_PolyComb
Fetal_Heart_Weak_transcription	Neurosphere_Cultured_Cells_Cortex_Derived_Weak_Repressed_PolyComb
H1_BMP4_Derived_Trophoblast_Cultured_Cells_Weak_transcription	Small_Intestine_Weak_Repressed_PolyComb
Chondrocytes_from_Bone_Marrow_Derived_Mesenchymal_Stem_Cell_Cultured_Cells_Strong_transcription	Muscle_Satellite_Cultured_Cells_Repressed_PolyComb
CD34_Primary_Cells_Weak_transcription	CD3_Primary_Cells_Peripheral_UW_Repressed_PolyComb
hESC_Derived_CD56pp_Mesoderm_Cultured_Cells_Weak_transcription	Brain_Mid_Frontal_Lobe_Weak_Repressed_PolyComb
GM12878_Lymphoblastoid_Strong_transcription	Brain_Hippocampus_Middle_Weak_Repressed_PolyComb
Fetal_Placenta_Strong_transcription	Penis_Foreskin_Keratinocyte_Primary_Cells_skin03_Weak_Repressed_PolyComb
HUVEC_Umbilical_Vein_Endothelial_Cells_Strong_transcription	Adipose_Nuclei_Weak_Repressed_PolyComb
HSMMtube_Skeletal_Muscle_Myotubes_Derived_from_HSMM_Weak_transcription	Sigmoid_Colon_Weak_Repressed_PolyComb
Placenta_Amnion_Strong_transcription	CD4pp_CD25__Th_Primary_Cells_Weak_Repressed_PolyComb
Fetal_Stomach_Strong_transcription	Adipose_Nuclei_Repressed_PolyComb
iPS_DF_19.11_Cell_Line_Weak_transcription	NHEK_Epidermal_Keratinocytes_Repressed_PolyComb
Rectal_Mucosa.Donor_29_Weak_transcription	Fetal_Adrenal_Gland_Repressed_PolyComb
Brain_Germinal_Matrix_Weak_transcription	Right_Ventricle_Weak_Repressed_PolyComb
CD19_Primary_Cells_Cord_BI_Strong_transcription	Rectal_Mucosa.Donor_29_Repressed_PolyComb
Rectal_Mucosa.Donor_29_Strong_transcription	Bone_Marrow_Derived_Mesenchymal_Stem_Cell_Cultured_Cells_Repressed_PolyComb
CD4pp_CD25__IL17pp_PMA_Ionomcyin_stimulated_Th17_Primary_Cells_Weak_transcription	CD4pp_CD25__IL17pp_PMA_Ionomcyin_stimulated_Th17_Primary_Cells_Repressed_PolyComb
Brain_Cingulate_Gyrus_Weak_transcription	Esophagus_Weak_Repressed_PolyComb
Chondrocytes_from_Bone_Marrow_Derived_Mesenchymal_Stem_Cell_Cultured_Cells_Repressed_PolyComb	Mobilized_CD34_Primary_Cells_Female_Weak_Repressed_PolyComb
Brain_Anterior_Caudate_Strong_transcription	H1_Derived_Neuronal_Progenitor_Cultured_Cells_Weak_Repressed_PolyComb
Colon_Smooth_Muscle_Strong_transcription	NHLF_Lung_Fibroblasts_Repressed_PolyComb
Fetal_Lung_Strong_transcription	Breast_vHMEC_Weak_Repressed_PolyComb
HUVEC_Umbilical_Vein_Endothelial_Cells_Weak_transcription	CD4pp_CD25__IL17__PMA_Ionomycin_stimulated_MACS_purified_Th_Primary_Cells_Weak_Repressed_PolyComb
HUES6_Cell_Line_Weak_Repressed_PolyComb	IMR90_Cell_Line_Repressed_PolyComb
Breast_vHMEC_Weak_transcription	Mesenchymal_Stem_Cell_Derived_Adipocyte_Cultured_Cells_Repressed_PolyComb
NHLF_Lung_Fibroblasts_Strong_transcription	Brain_Angular_Gyrus_Weak_Repressed_PolyComb
4star_Strong_transcription	Brain_Cingulate_Gyrus_Weak_Repressed_PolyComb
Colon_Smooth_Muscle_Weak_transcription	CD34_Primary_Cells_Weak_Repressed_PolyComb
Stomach_Smooth_Muscle_Weak_transcription	HUES6_Cell_Line_Bivalent_Enhancer
Duodenum_Mucosa_Strong_transcription	Osteoblasts_Repressed_PolyComb
Adult_Liver_Strong_transcription	Rectal_Mucosa.Donor_31_Repressed_PolyComb
HMEC_Mammary_Epithelial_Strong_transcription	CD8_Naive_Primary_Cells_Weak_Repressed_PolyComb
hESC_Derived_CD56pp_Ectoderm_Cultured_Cells_Weak_transcription	NHDF_Ad_Adult_Dermal_Fibroblasts_Repressed_PolyComb
Mobilized_CD34_Primary_Cells_Male_Heterochromatin	Penis_Foreskin_Keratinocyte_Primary_Cells_skin02_Weak_Repressed_PolyComb
Fetal_Brain_Female_Weak_transcription	Chondrocytes_from_Bone_Marrow_Derived_Mesenchymal_Stem_Cell_Cultured_Cells_Repressed_PolyComb
Brain_Inferior_Temporal_Lobe_Strong_transcription	Muscle_Satellite_Cultured_Cells_Weak_Repressed_PolyComb
ES_I3_Cell_Line_Weak_transcription	Brain_Cingulate_Gyrus_Repressed_PolyComb
Fetal_Muscle_Trunk_Weak_transcription	iPS_18_Cell_Line_Bivalent_Enhancer
Bone_Marrow_Derived_Mesenchymal_Stem_Cell_Cultured_Cells_Repressed_PolyComb	NHDF_Ad_Adult_Dermal_Fibroblasts_Weak_Repressed_PolyComb
Sigmoid_Colon_Strong_transcription	CD3_Primary_Cells_Peripheral_UW_Weak_Repressed_PolyComb
Breast_Myoepithelial_Cells_Strong_transcription	Small_Intestine_Repressed_PolyComb
NHLF_Lung_Fibroblasts_Weak_transcription	CD4pp_CD25__CD45ROpp_Memory_Primary_Cells_Weak_Repressed_PolyComb
Penis_Foreskin_Keratinocyte_Primary_Cells_skin03_Strong_transcription	Penis_Foreskin_Fibroblast_Primary_Cells_skin02_Weak_Repressed_PolyComb
CD4pp_CD25__CD45RApp_Naive_Primary_Cells_Weak_transcription	Fetal_Kidney_Repressed_PolyComb
Peripheral_Blood_Mononuclear_Primary_Cells_Strong_transcription	HUVEC_Umbilical_Vein_Endothelial_Cells_Repressed_PolyComb
IMR90_Cell_Line_Weak_transcription	Brain_Hippocampus_Middle_Repressed_PolyComb
Penis_Foreskin_Fibroblast_Primary_Cells_skin01_Weak_transcription	Brain_Inferior_Temporal_Lobe_Weak_Repressed_PolyComb
CD4pp_CD25__IL17__PMA_Ionomycin_stimulated_MACS_purified_Th_Primary_Cells_Strong_transcription	Ovary_Repressed_PolyComb
Lung_Weak_transcription	Peripheral_Blood_Mononuclear_Primary_Cells_Repressed_PolyComb
CD3_Primary_Cells_Peripheral_UW_Weak_transcription	Right_Ventricle_Repressed_PolyComb
Penis_Foreskin_Keratinocyte_Primary_Cells_skin03_Heterochromatin	Stomach_Smooth_Muscle_Weak_Repressed_PolyComb
H9_Cell_Line_Strong_transcription	HSMM_Skeletal_Muscle_Myoblasts_Weak_Repressed_PolyComb
CD15_Primary_Cells_Heterochromatin	Osteoblasts_Weak_Repressed_PolyComb
Brain_Cingulate_Gyrus_Strong_transcription	ES_I3_Cell_Line_Bivalent_Enhancer
CD14_Primary_Cells_Repressed_PolyComb	CD19_Primary_Cells_Peripheral_UW_Repressed_PolyComb
CD4_Naive_Primary_Cells_Strong_transcription	Fetal_Placenta_Repressed_PolyComb
HSMM_Skeletal_Muscle_Myoblasts_Strong_transcription	GM12878_Lymphoblastoid_Weak_Repressed_PolyComb
Fetal_Stomach_Weak_transcription	Penis_Foreskin_Melanocyte_Primary_Cells_skin01_Repressed_PolyComb
iPS_18_Cell_Line_Strong_transcription	CD56_Primary_Cells_Repressed_PolyComb
hESC_Derived_CD184pp_Endoderm_Cultured_Cells_Strong_transcription	Adipose_Derived_Mesenchymal_Stem_Cell_Cultured_Cells_Weak_Repressed_PolyComb
Peripheral_Blood_Mononuclear_Primary_Cells_Weak_transcription	Placenta_Amnion_Repressed_PolyComb
Left_Ventricle_Weak_transcription	Mesenchymal_Stem_Cell_Derived_Adipocyte_Cultured_Cells_Weak_Repressed_PolyComb
Penis_Foreskin_Fibroblast_Primary_Cells_skin02_Weak_transcription	HepG2_Hepatocellular_Carcinoma_Repressed_PolyComb
Fetal_Intestine_Small_Weak_transcription	Penis_Foreskin_Melanocyte_Primary_Cells_skin03_Repressed_PolyComb
hESC_Derived_CD184pp_Endoderm_Cultured_Cells_Weak_Repressed_PolyComb	Right_Atrium_Repressed_PolyComb
HUES48_Cell_Line_Heterochromatin	Brain_Anterior_Caudate_Weak_Repressed_PolyComb
HeLa_S3_Cervical_Carcinoma_Weak_transcription	hESC_Derived_CD56pp_Mesoderm_Cultured_Cells_Repressed_PolyComb
Right_Atrium_Weak_transcription	HUVEC_Umbilical_Vein_Endothelial_Cells_Weak_Repressed_PolyComb
Penis_Foreskin_Keratinocyte_Primary_Cells_skin02_Heterochromatin	Left_Ventricle_Repressed_PolyComb
NH_A_Astrocytes_Strong_transcription	Lung_Weak_Repressed_PolyComb
Brain_Angular_Gyrus_Weak_transcription	Penis_Foreskin_Fibroblast_Primary_Cells_skin01_Weak_Repressed_PolyComb
GM12878_Lymphoblastoid_Heterochromatin	Fetal_Muscle_Trunk_Bivalent_Enhancer
Mobilized_CD34_Primary_Cells_Female_Heterochromatin	HepG2_Hepatocellular_Carcinoma_Weak_Repressed_PolyComb
Colonic_Mucosa_Strong_transcription	CD4pp_CD25__CD45RApp_Naive_Primary_Cells_Repressed_PolyComb
CD34_Primary_Cells_Strong_transcription	4star_Weak_Repressed_PolyComb
Fetal_Placenta_Heterochromatin	HSMMtube_Skeletal_Muscle_Myotubes_Derived_from_HSMM_Repressed_PolyComb
Fetal_Intestine_Small_Strong_transcription	Fetal_Adrenal_Gland_Weak_Repressed_PolyComb
Spleen_Weak_transcription	HSMM_Skeletal_Muscle_Myoblasts_Repressed_PolyComb
iPS_15b_Cell_Line_Strong_transcription	Colonic_Mucosa_Repressed_PolyComb
Brain_Mid_Frontal_Lobe_Weak_transcription	Brain_Inferior_Temporal_Lobe_Repressed_PolyComb
NHDF_Ad_Adult_Dermal_Fibroblasts_Strong_transcription	Bone_Marrow_Derived_Mesenchymal_Stem_Cell_Cultured_Cells_Weak_Repressed_PolyComb
Mobilized_CD34_Primary_Cells_Female_Strong_transcription	Penis_Foreskin_Melanocyte_Primary_Cells_skin01_Weak_Repressed_PolyComb
NHEK_Epidermal_Keratinocytes_Strong_transcription	Ovary_Weak_Repressed_PolyComb
HUES64_Cell_Line_Heterochromatin	iPS_20b_Cell_Line_Bivalent_Enhancer
Breast_Myoepithelial_Cells_Heterochromatin	Penis_Foreskin_Fibroblast_Primary_Cells_skin02_Bivalent_Enhancer
CD34_Cultured_Cells_Strong_transcription	Brain_Mid_Frontal_Lobe_Repressed_PolyComb
Monocytes_CD14pp_RO01746_Heterochromatin	Fetal_Muscle_Leg_Bivalent_Enhancer
HSMMtube_Skeletal_Muscle_Myotubes_Derived_from_HSMM_Strong_transcription	Colon_Smooth_Muscle_Repressed_PolyComb
CD4_Memory_Primary_Cells_Weak_transcription	Left_Ventricle_Weak_Repressed_PolyComb
H1_Derived_Mesenchymal_Stem_Cells_Weak_transcription	HMEC_Mammary_Epithelial_Weak_Repressed_PolyComb
Ovary_Strong_transcription	HepG2_Hepatocellular_Carcinoma_Bivalent_Enhancer
HUVEC_Umbilical_Vein_Endothelial_Cells_Repressed_PolyComb	Mobilized_CD34_Primary_Cells_Male_Weak_Repressed_PolyComb
Mobilized_CD34_Primary_Cells_Male_Strong_transcription	Pancreatic_Islets_Weak_Repressed_PolyComb
Placenta_Amnion_Weak_transcription	Penis_Foreskin_Fibroblast_Primary_Cells_skin01_Bivalent_Enhancer
hESC_Derived_CD56pp_Mesoderm_Cultured_Cells_Strong_transcription	Rectal_Smooth_Muscle_Repressed_PolyComb
Penis_Foreskin_Melanocyte_Primary_Cells_skin01_Weak_transcription	Brain_Angular_Gyrus_Repressed_PolyComb
hESC_Derived_CD56pp_Mesoderm_Cultured_Cells_Heterochromatin	iPS_DF_19.11_Cell_Line_Enhancers
H9_Cell_Line_Weak_transcription	HUES64_Cell_Line_Bivalent_Enhancer
Pancreas_Weak_Repressed_PolyComb	H1_Cell_Line_Bivalent_Enhancer
Rectal_Smooth_Muscle_Strong_transcription	CD8_Naive_Primary_Cells_Repressed_PolyComb
Brain_Substantia_Nigra_Strong_transcription	Brain_Substantia_Nigra_Repressed_PolyComb
Sigmoid_Colon_Weak_transcription	CD4pp_CD25__CD45ROpp_Memory_Primary_Cells_Repressed_PolyComb
CD8_Naive_Primary_Cells_Weak_transcription	IMR90_Cell_Line_Weak_Repressed_PolyComb
CD4_Naive_Primary_Cells_Weak_transcription	Dnd41_TCell_Leukemia_Repressed_PolyComb
iPS_20b_Cell_Line_Heterochromatin	Fetal_Stomach_Bivalent_Enhancer
iPS_20b_Cell_Line_Strong_transcription	K562_Leukemia_Weak_Repressed_PolyComb
IMR90_Cell_Line_Repressed_PolyComb	Pancreatic_Islets_Repressed_PolyComb
HUES6_Cell_Line_Strong_transcription	Sigmoid_Colon_Repressed_PolyComb
Left_Ventricle_Strong_transcription	HSMMtube_Skeletal_Muscle_Myotubes_Derived_from_HSMM_Weak_Repressed_PolyComb
NHEK_Epidermal_Keratinocytes_Heterochromatin	Breast_Myoepithelial_Cells_Repressed_PolyComb
Breast_vHMEC_Heterochromatin	Lung_Repressed_PolyComb
Ovary_Weak_transcription	Chondrocytes_from_Bone_Marrow_Derived_Mesenchymal_Stem_Cell_Cultured_Cells_Weak_Repressed_PolyComb
Stomach_Mucosa_Weak_transcription	Penis_Foreskin_Fibroblast_Primary_Cells_skin02_Bivalent_Poised_TSS
HUES48_Cell_Line_Strong_transcription	H9_Derived_Neuronal_Progenitor_Cultured_Cells_Bivalent_Enhancer
CD4pp_CD25int_CD127pp_Tmem_Primary_Cells_Weak_transcription	Adult_Liver_Repressed_PolyComb
CD15_Primary_Cells_Repressed_PolyComb	Brain_Anterior_Caudate_Repressed_PolyComb
CD19_Primary_Cells_Peripheral_UW_Strong_transcription	Penis_Foreskin_Melanocyte_Primary_Cells_skin01_Bivalent_Enhancer
H1_Derived_Mesenchymal_Stem_Cells_Heterochromatin	HUES48_Cell_Line_Bivalent_Enhancer
Penis_Foreskin_Fibroblast_Primary_Cells_skin01_Weak_Repressed_PolyComb	Dnd41_TCell_Leukemia_Weak_Repressed_PolyComb
Duodenum_Mucosa_Heterochromatin	Breast_vHMEC_Repressed_PolyComb
Thymus_Weak_transcription	Skeletal_Muscle_Male_Bivalent_Enhancer
Penis_Foreskin_Melanocyte_Primary_Cells_skin03_Heterochromatin	ES_WA7_Cell_Line_Bivalent_Enhancer
iPS_18_Cell_Line_Heterochromatin	Fetal_Adrenal_Gland_Bivalent_Enhancer
Brain_Angular_Gyrus_Strong_transcription	Stomach_Smooth_Muscle_Bivalent_Enhancer
K562_Leukemia_Strong_transcription	Aorta_Weak_Repressed_PolyComb
Fetal_Thymus_Strong_transcription	A549_EtOH_0.02pct_Lung_Carcinoma_Repressed_PolyComb
Brain_Mid_Frontal_Lobe_Strong_transcription	H9_Derived_Neuron_Cultured_Cells_Bivalent_Enhancer
CD3_Primary_Cells_Cord_BI_Repressed_PolyComb	Duodenum_Mucosa_Bivalent_Enhancer
Rectal_Smooth_Muscle_Weak_transcription	Adipose_Derived_Mesenchymal_Stem_Cell_Cultured_Cells_Bivalent_Enhancer
Osteoblasts_Repressed_PolyComb	Fetal_Placenta_Bivalent_Enhancer
Fetal_Intestine_Small_Heterochromatin	H1_BMP4_Derived_Mesendoderm_Cultured_Cells_Repressed_PolyComb
Mobilized_CD34_Primary_Cells_Female_Repressed_PolyComb	hESC_Derived_CD56pp_Ectoderm_Cultured_Cells_Bivalent_Enhancer
Fetal_Muscle_Leg_Heterochromatin	HeLa_S3_Cervical_Carcinoma_Repressed_PolyComb
CD3_Primary_Cells_Peripheral_UW_Strong_transcription	Penis_Foreskin_Melanocyte_Primary_Cells_skin03_Weak_Repressed_PolyComb
CD4pp_CD25pp_CD127__Treg_Primary_Cells_Strong_transcription	CD8_Memory_Primary_Cells_Repressed_PolyComb
Adipose_Derived_Mesenchymal_Stem_Cell_Cultured_Cells_Repressed_PolyComb	4star_Enhancers
A549_EtOH_0.02pct_Lung_Carcinoma_Strong_transcription	K562_Leukemia_Repressed_PolyComb
CD4_Memory_Primary_Cells_Strong_transcription	CD3_Primary_Cells_Peripheral_UW_Bivalent_Enhancer
CD8_Naive_Primary_Cells_Strong_transcription	Penis_Foreskin_Keratinocyte_Primary_Cells_skin02_Bivalent_Enhancer
HeLa_S3_Cervical_Carcinoma_Strong_transcription	GM12878_Lymphoblastoid_Repressed_PolyComb
CD8_Memory_Primary_Cells_Weak_transcription	Skeletal_Muscle_Female_Bivalent_Enhancer
H1_Cell_Line_Heterochromatin	HMEC_Mammary_Epithelial_Repressed_PolyComb
Right_Ventricle_Weak_transcription	H1_Derived_Mesenchymal_Stem_Cells_Bivalent_Enhancer
Right_Ventricle_Strong_transcription	Penis_Foreskin_Keratinocyte_Primary_Cells_skin03_Bivalent_Enhancer
Lung_Strong_transcription	IMR90_Cell_Line_Bivalent_Enhancer
CD34_Primary_Cells_Heterochromatin	A549_EtOH_0.02pct_Lung_Carcinoma_Weak_Repressed_PolyComb
H1_BMP4_Derived_Trophoblast_Cultured_Cells_Strong_transcription	HeLa_S3_Cervical_Carcinoma_Weak_Repressed_PolyComb
Adult_Liver_Heterochromatin	Adult_Liver_Weak_Repressed_PolyComb
H9_Derived_Neuron_Cultured_Cells_Strong_transcription	Right_Atrium_Weak_Repressed_PolyComb
Fetal_Kidney_Weak_transcription	Fetal_Intestine_Small_Bivalent_Enhancer
Fetal_Brain_Female_Heterochromatin	Breast_Myoepithelial_Cells_Weak_Repressed_PolyComb
HUES64_Cell_Line_Strong_transcription	iPS_DF_19.11_Cell_Line_Weak_transcription
H1_Derived_Neuronal_Progenitor_Cultured_Cells_Weak_transcription	Fetal_Intestine_Large_Bivalent_Enhancer
iPS_15b_Cell_Line_Heterochromatin	Stomach_Mucosa_Bivalent_Enhancer
Spleen_Strong_transcription	Spleen_Enhancers
Brain_Germinal_Matrix_Heterochromatin	CD4pp_CD25int_CD127pp_Tmem_Primary_Cells_Repressed_PolyComb
Penis_Foreskin_Fibroblast_Primary_Cells_skin02_Strong_transcription	Penis_Foreskin_Fibroblast_Primary_Cells_skin02_Flanking_Bivalent_TSS_Enh
Adipose_Nuclei_Heterochromatin	Adipose_Nuclei_Bivalent_Enhancer
Muscle_Satellite_Cultured_Cells_Repressed_PolyComb	K562_Leukemia_Enhancers
CD4pp_CD25__Th_Primary_Cells_Strong_transcription	Fetal_Thymus_Bivalent_Enhancer
Dnd41_TCell_Leukemia_Heterochromatin	Neurosphere_Cultured_Cells_Cortex_Derived_Bivalent_Enhancer
Monocytes_CD14pp_RO01746_Weak_Repressed_PolyComb	Fetal_Placenta_Enhancers
Breast_vHMEC_Strong_transcription	HepG2_Hepatocellular_Carcinoma_Flanking_Active_TSS
ES_I3_Cell_Line_Heterochromatin	iPS_18_Cell_Line_Enhancers
CD34_Cultured_Cells_Heterochromatin	Fetal_Thymus_Enhancers
Fetal_Lung_Repressed_PolyComb	Colonic_Mucosa_Bivalent_Enhancer
CD15_Primary_Cells_Strong_transcription	Mobilized_CD34_Primary_Cells_Male_Bivalent_Enhancer
hESC_Derived_CD184pp_Endoderm_Cultured_Cells_Heterochromatin	NHEK_Epidermal_Keratinocytes_Bivalent_Enhancer
Fetal_Adrenal_Gland_Heterochromatin	Colonic_Mucosa_Enhancers
CD14_Primary_Cells_Weak_Repressed_PolyComb	CD34_Cultured_Cells_Enhancers
Esophagus_Weak_transcription	Fetal_Brain_Male_Bivalent_Enhancer
Pancreas_Weak_transcription	HepG2_Hepatocellular_Carcinoma_Enhancers
CD4pp_CD25__CD45ROpp_Memory_Primary_Cells_Weak_transcription	CD56_Primary_Cells_Enhancers
Gastric_Weak_transcription	Fetal_Intestine_Small_Enhancers
Neurosphere_Cultured_Cells_Cortex_Derived_Repressed_PolyComb	Mobilized_CD34_Primary_Cells_Female_Enhancers
Neurosphere_Cultured_Cells_Ganglionic_Eminence_Derived_Heterochromatin	Fetal_Lung_Bivalent_Enhancer
CD56_Primary_Cells_Strong_transcription	HepG2_Hepatocellular_Carcinoma_Flanking_Bivalent_TSS_Enh
Colonic_Mucosa_Weak_transcription	Esophagus_Enhancers
Dnd41_TCell_Leukemia_Strong_transcription	Rectal_Mucosa.Donor_29_Enhancers
CD56_Primary_Cells_Heterochromatin	Duodenum_Mucosa_Enhancers
ES_I3_Cell_Line_Strong_transcription	iPS_DF_6.9_Cell_Line_Enhancers
CD19_Primary_Cells_Peripheral_UW_Heterochromatin	H1_Cell_Line_Enhancers
Neurosphere_Cultured_Cells_Cortex_Derived_Heterochromatin	Fetal_Intestine_Large_Enhancers
HUVEC_Umbilical_Vein_Endothelial_Cells_Heterochromatin	HeLa_S3_Cervical_Carcinoma_Flanking_Active_TSS
CD8_Memory_Primary_Cells_Strong_transcription	Monocytes_CD14pp_RO01746_Bivalent_Enhancer
hESC_Derived_CD184pp_Endoderm_Cultured_Cells_Repressed_PolyComb	Breast_Myoepithelial_Cells_Enhancers
iPS_DF_6.9_Cell_Line_Weak_transcription	CD34_Primary_Cells_Enhancers
H9_Derived_Neuronal_Progenitor_Cultured_Cells_Repressed_PolyComb	CD19_Primary_Cells_Peripheral_UW_Enhancers
Lung_Weak_Repressed_PolyComb	Mobilized_CD34_Primary_Cells_Male_Enhancers
Fetal_Intestine_Large_Heterochromatin	hESC_Derived_CD56pp_Ectoderm_Cultured_Cells_Enhancers
Mobilized_CD34_Primary_Cells_Male_Weak_Repressed_PolyComb	Right_Atrium_Weak_transcription
Mesenchymal_Stem_Cell_Derived_Adipocyte_Cultured_Cells_Heterochromatin	Gastric_Weak_Repressed_PolyComb
Fetal_Brain_Male_Weak_transcription	iPS_DF_19.11_Cell_Line_Genic_enhancers
H9_Derived_Neuronal_Progenitor_Cultured_Cells_Heterochromatin	HeLa_S3_Cervical_Carcinoma_Enhancers
Fetal_Muscle_Trunk_Heterochromatin	Rectal_Mucosa.Donor_31_Enhancers
Chondrocytes_from_Bone_Marrow_Derived_Mesenchymal_Stem_Cell_Cultured_Cells_Heterochromatin	Lung_Enhancers
Fetal_Muscle_Trunk_Weak_Repressed_PolyComb	H1_Derived_Mesenchymal_Stem_Cells_Enhancers
NHDF_Ad_Adult_Dermal_Fibroblasts_Repressed_PolyComb	Dnd41_TCell_Leukemia_Enhancers
Gastric_Strong_transcription	CD4pp_CD25__Th_Primary_Cells_Enhancers
Pancreatic_Islets_Weak_transcription	H1_Derived_Mesenchymal_Stem_Cells_Bivalent_Poised_TSS
iPS_DF_6.9_Cell_Line_Strong_transcription	Dnd41_TCell_Leukemia_Flanking_Active_TSS
H1_BMP4_Derived_Mesendoderm_Cultured_Cells_Weak_transcription	CD14_Primary_Cells_Enhancers
H1_Derived_Mesenchymal_Stem_Cells_Strong_transcription	Fetal_Muscle_Leg_Enhancers
Penis_Foreskin_Fibroblast_Primary_Cells_skin01_Repressed_PolyComb	CD19_Primary_Cells_Cord_BI_Enhancers
A549_EtOH_0.02pct_Lung_Carcinoma_Repressed_PolyComb	K562_Leukemia_Flanking_Active_TSS
Fetal_Adrenal_Gland_Weak_Repressed_PolyComb	Mobilized_CD34_Primary_Cells_Male_Flanking_Active_TSS
Psoas_Muscle_Weak_transcription	Pancreas_Enhancers
H9_Cell_Line_Heterochromatin	Penis_Foreskin_Fibroblast_Primary_Cells_skin02_Flanking_Active_TSS
Adipose_Derived_Mesenchymal_Stem_Cell_Cultured_Cells_Weak_Repressed_PolyComb	Mesenchymal_Stem_Cell_Derived_Adipocyte_Cultured_Cells_Bivalent_Enhancer
Penis_Foreskin_Melanocyte_Primary_Cells_skin01_Strong_transcription	H1_BMP4_Derived_Trophoblast_Cultured_Cells_Enhancers
Fetal_Stomach_Weak_Repressed_PolyComb	CD4_Naive_Primary_Cells_Repressed_PolyComb
Pancreas_Strong_transcription	Fetal_Muscle_Trunk_Enhancers
Fetal_Heart_Repressed_PolyComb	Monocytes_CD14pp_RO01746_Enhancers
Pancreatic_Islets_Heterochromatin	Brain_Mid_Frontal_Lobe_Enhancers
Fetal_Placenta_Weak_Repressed_PolyComb	CD4pp_CD25__IL17__PMA_Ionomycin_stimulated_MACS_purified_Th_Primary_Cells_Enhancers
Penis_Foreskin_Melanocyte_Primary_Cells_skin01_Heterochromatin	H1_Derived_Neuronal_Progenitor_Cultured_Cells_Enhancers
Adipose_Derived_Mesenchymal_Stem_Cell_Cultured_Cells_Heterochromatin	Monocytes_CD14pp_RO01746_Flanking_Active_TSS
CD19_Primary_Cells_Cord_BI_Heterochromatin	CD4pp_CD25__IL17pp_PMA_Ionomcyin_stimulated_Th17_Primary_Cells_Enhancers
Aorta_Strong_transcription	A549_EtOH_0.02pct_Lung_Carcinoma_Enhancers
Fetal_Brain_Female_Repressed_PolyComb	H1_BMP4_Derived_Trophoblast_Cultured_Cells_Repressed_PolyComb
H9_Derived_Neuronal_Progenitor_Cultured_Cells_Strong_transcription	CD4pp_CD25int_CD127pp_Tmem_Primary_Cells_Enhancers
Esophagus_Strong_transcription	Muscle_Satellite_Cultured_Cells_Bivalent_Enhancer
Placenta_Amnion_Heterochromatin	Penis_Foreskin_Fibroblast_Primary_Cells_skin01_Flanking_Active_TSS
Aorta_Heterochromatin	CD4_Naive_Primary_Cells_Enhancers
H9_Derived_Neuron_Cultured_Cells_Repressed_PolyComb	Brain_Germinal_Matrix_Enhancers
CD34_Primary_Cells_Repressed_PolyComb	Fetal_Brain_Male_Enhancers
Thymus_Repressed_PolyComb	Thymus_Enhancers
Mesenchymal_Stem_Cell_Derived_Adipocyte_Cultured_Cells_Repressed_PolyComb	CD8_Naive_Primary_Cells_Enhancers
CD14_Primary_Cells_Strong_transcription	CD3_Primary_Cells_Peripheral_UW_Enhancers
CD4pp_CD25pp_CD127__Treg_Primary_Cells_Heterochromatin	Brain_Germinal_Matrix_Bivalent_Enhancer
Muscle_Satellite_Cultured_Cells_Heterochromatin	HUES6_Cell_Line_Enhancers
Lung_Heterochromatin	CD4pp_CD25__CD45RApp_Naive_Primary_Cells_Enhancers
HSMMtube_Skeletal_Muscle_Myotubes_Derived_from_HSMM_Repressed_PolyComb	Peripheral_Blood_Mononuclear_Primary_Cells_Enhancers
CD4pp_CD25__CD45ROpp_Memory_Primary_Cells_Strong_transcription	Duodenum_Mucosa_Flanking_Active_TSS
Fetal_Stomach_Heterochromatin	CD8_Memory_Primary_Cells_Enhancers
4star_Heterochromatin	Penis_Foreskin_Keratinocyte_Primary_Cells_skin03_Enhancers
Brain_Anterior_Caudate_Heterochromatin	Penis_Foreskin_Keratinocyte_Primary_Cells_skin02_Enhancers
ES_WA7_Cell_Line_Weak_transcription	GM12878_Lymphoblastoid_Enhancers
H1_Derived_Neuronal_Progenitor_Cultured_Cells_Strong_transcription	Right_Ventricle_Enhancers
Sigmoid_Colon_Heterochromatin	Chondrocytes_from_Bone_Marrow_Derived_Mesenchymal_Stem_Cell_Cultured_Cells_Bivalent_Enhancer
CD4pp_CD25__Th_Primary_Cells_Heterochromatin	Neurosphere_Cultured_Cells_Ganglionic_Eminence_Derived_Enhancers
Peripheral_Blood_Mononuclear_Primary_Cells_Heterochromatin	Penis_Foreskin_Fibroblast_Primary_Cells_skin02_Active_TSS
HepG2_Hepatocellular_Carcinoma_Heterochromatin	Adipose_Nuclei_Enhancers
Duodenum_Smooth_Muscle_Heterochromatin	Neurosphere_Cultured_Cells_Cortex_Derived_Enhancers
HeLa_S3_Cervical_Carcinoma_Repressed_PolyComb	Penis_Foreskin_Melanocyte_Primary_Cells_skin01_Enhancers
Fetal_Thymus_Repressed_PolyComb	Mobilized_CD34_Primary_Cells_Female_Flanking_Active_TSS
H1_BMP4_Derived_Mesendoderm_Cultured_Cells_Heterochromatin	HMEC_Mammary_Epithelial_Enhancers
IMR90_Cell_Line_Weak_Repressed_PolyComb	Stomach_Mucosa_Enhancers
Fetal_Kidney_Strong_transcription	Fetal_Brain_Female_Enhancers
Fetal_Intestine_Large_Repressed_PolyComb	Rectal_Mucosa.Donor_29_Flanking_Active_TSS
Monocytes_CD14pp_RO01746_Strong_transcription	CD15_Primary_Cells_Enhancers
HepG2_Hepatocellular_Carcinoma_Repressed_PolyComb	CD4_Memory_Primary_Cells_Enhancers
NH_A_Astrocytes_Repressed_PolyComb	Brain_Inferior_Temporal_Lobe_Enhancers
CD19_Primary_Cells_Cord_BI_Repressed_PolyComb	Brain_Mid_Frontal_Lobe_Active_TSS
Fetal_Lung_Weak_Repressed_PolyComb	CD4pp_CD25pp_CD127__Treg_Primary_Cells_Enhancers
Stomach_Smooth_Muscle_Heterochromatin	Rectal_Smooth_Muscle_Active_TSS
H9_Derived_Neuron_Cultured_Cells_Heterochromatin	Gastric_Enhancers
NHLF_Lung_Fibroblasts_Repressed_PolyComb	Osteoblasts_Bivalent_Enhancer
Penis_Foreskin_Keratinocyte_Primary_Cells_skin02_Repressed_PolyComb	Fetal_Brain_Female_Active_TSS
Brain_Hippocampus_Middle_Heterochromatin	Penis_Foreskin_Keratinocyte_Primary_Cells_skin02_Flanking_Active_TSS
Fetal_Brain_Male_Repressed_PolyComb	Adult_Liver_Enhancers
Right_Atrium_Heterochromatin	Brain_Cingulate_Gyrus_Enhancers
Breast_Myoepithelial_Cells_Repressed_PolyComb	CD4pp_CD25__CD45ROpp_Memory_Primary_Cells_Enhancers
Penis_Foreskin_Fibroblast_Primary_Cells_skin02_Weak_Repressed_PolyComb	Stomach_Smooth_Muscle_Flanking_Active_TSS
CD4pp_CD25__CD45RApp_Naive_Primary_Cells_Heterochromatin	Adipose_Nuclei_Flanking_Active_TSS
NHLF_Lung_Fibroblasts_Heterochromatin	hESC_Derived_CD56pp_Mesoderm_Cultured_Cells_Enhancers
hESC_Derived_CD56pp_Mesoderm_Cultured_Cells_Weak_Repressed_PolyComb	Psoas_Muscle_Repressed_PolyComb
Bone_Marrow_Derived_Mesenchymal_Stem_Cell_Cultured_Cells_Heterochromatin	NHEK_Epidermal_Keratinocytes_Enhancers
Rectal_Mucosa.Donor_29_Heterochromatin	CD4pp_CD25__IL17__PMA_Ionomycin_stimulated_MACS_purified_Th_Primary_Cells_Flanking_Active_TSS
Fetal_Thymus_Heterochromatin	Brain_Anterior_Caudate_Enhancers
Skeletal_Muscle_Male_Repressed_PolyComb	Skeletal_Muscle_Female_Enhancers
Skeletal_Muscle_Male_Weak_Repressed_PolyComb	H9_Derived_Neuronal_Progenitor_Cultured_Cells_Enhancers
NHEK_Epidermal_Keratinocytes_Repressed_PolyComb	Brain_Hippocampus_Middle_Enhancers
Brain_Inferior_Temporal_Lobe_Heterochromatin	CD3_Primary_Cells_Cord_BI_Enhancers
Left_Ventricle_Heterochromatin	GM12878_Lymphoblastoid_Flanking_Active_TSS
CD3_Primary_Cells_Cord_BI_Heterochromatin	Fetal_Adrenal_Gland_Enhancers
Spleen_Heterochromatin	Skeletal_Muscle_Male_Flanking_Active_TSS
NH_A_Astrocytes_Heterochromatin	Stomach_Smooth_Muscle_Enhancers
CD4pp_CD25pp_CD127__Treg_Primary_Cells_Repressed_PolyComb	Pancreatic_Islets_Active_TSS
A549_EtOH_0.02pct_Lung_Carcinoma_Heterochromatin	Brain_Anterior_Caudate_Active_TSS
HUES64_Cell_Line_Repressed_PolyComb	Brain_Inferior_Temporal_Lobe_Flanking_Active_TSS
Aorta_Weak_transcription	Rectal_Mucosa.Donor_29_Active_TSS
hESC_Derived_CD56pp_Ectoderm_Cultured_Cells_Heterochromatin	Aorta_Repressed_PolyComb
CD3_Primary_Cells_Peripheral_UW_Heterochromatin	Brain_Anterior_Caudate_Flanking_Active_TSS
Small_Intestine_Weak_transcription	Penis_Foreskin_Keratinocyte_Primary_Cells_skin03_Flanking_Active_TSS
HepG2_Hepatocellular_Carcinoma_Weak_Repressed_PolyComb	CD15_Primary_Cells_Flanking_Active_TSS
Fetal_Muscle_Leg_Weak_Repressed_PolyComb	Penis_Foreskin_Fibroblast_Primary_Cells_skin02_Enhancers
Esophagus_Weak_Repressed_PolyComb	Breast_vHMEC_Enhancers
iPS_DF_6.9_Cell_Line_Heterochromatin	Placenta_Amnion_Enhancers
H1_BMP4_Derived_Mesendoderm_Cultured_Cells_Repressed_PolyComb	Brain_Angular_Gyrus_Enhancers
Colonic_Mucosa_Heterochromatin	Rectal_Mucosa.Donor_31_Flanking_Active_TSS
Brain_Substantia_Nigra_Heterochromatin	Fetal_Brain_Female_Bivalent_Enhancer
Fetal_Brain_Male_Weak_Repressed_PolyComb	Duodenum_Smooth_Muscle_Active_TSS
Penis_Foreskin_Melanocyte_Primary_Cells_skin03_Repressed_PolyComb	Skeletal_Muscle_Male_Enhancers
Stomach_Smooth_Muscle_Repressed_PolyComb	Brain_Hippocampus_Middle_Flanking_Active_TSS
Fetal_Lung_Heterochromatin	NHEK_Epidermal_Keratinocytes_Flanking_Active_TSS
Penis_Foreskin_Keratinocyte_Primary_Cells_skin03_Repressed_PolyComb	CD19_Primary_Cells_Peripheral_UW_Bivalent_Enhancer
Fetal_Adrenal_Gland_Repressed_PolyComb	ES_I3_Cell_Line_Enhancers
Psoas_Muscle_Heterochromatin	Chondrocytes_from_Bone_Marrow_Derived_Mesenchymal_Stem_Cell_Cultured_Cells_Flanking_Active_TSS
HSMMtube_Skeletal_Muscle_Myotubes_Derived_from_HSMM_Heterochromatin	Sigmoid_Colon_Enhancers
CD4pp_CD25__IL17__PMA_Ionomycin_stimulated_MACS_purified_Th_Primary_Cells_Heterochromatin	Skeletal_Muscle_Female_Flanking_Active_TSS
Breast_Myoepithelial_Cells_Weak_Repressed_PolyComb	Breast_Myoepithelial_Cells_Bivalent_Enhancer
Fetal_Kidney_Repressed_PolyComb	A549_EtOH_0.02pct_Lung_Carcinoma_Flanking_Active_TSS
hESC_Derived_CD56pp_Mesoderm_Cultured_Cells_Repressed_PolyComb	Adipose_Derived_Mesenchymal_Stem_Cell_Cultured_Cells_Flanking_Active_TSS
HUES6_Cell_Line_Repressed_PolyComb	H9_Derived_Neuron_Cultured_Cells_Enhancers
ES_WA7_Cell_Line_Weak_Repressed_PolyComb	hESC_Derived_CD184pp_Endoderm_Cultured_Cells_Enhancers
Brain_Mid_Frontal_Lobe_Heterochromatin	Left_Ventricle_Enhancers
Fetal_Kidney_Weak_Repressed_PolyComb	Fetal_Stomach_Enhancers
Thymus_Heterochromatin	Brain_Hippocampus_Middle_Bivalent_Enhancer
Small_Intestine_Strong_transcription	K562_Leukemia_Bivalent_Enhancer
Esophagus_Heterochromatin	ES_WA7_Cell_Line_Enhancers
Colon_Smooth_Muscle_Weak_Repressed_PolyComb	HSMM_Skeletal_Muscle_Myoblasts_Enhancers
Mesenchymal_Stem_Cell_Derived_Adipocyte_Cultured_Cells_Weak_Repressed_PolyComb	Brain_Mid_Frontal_Lobe_Flanking_Active_TSS
Mobilized_CD34_Primary_Cells_Male_ZNF_genes_and_repeats	Brain_Substantia_Nigra_Enhancers
Chondrocytes_from_Bone_Marrow_Derived_Mesenchymal_Stem_Cell_Cultured_Cells_Weak_Repressed_PolyComb	Fetal_Lung_Enhancers
Rectal_Mucosa.Donor_31_Heterochromatin	Duodenum_Smooth_Muscle_Enhancers
Brain_Cingulate_Gyrus_Heterochromatin	Fetal_Kidney_Bivalent_Enhancer
Mobilized_CD34_Primary_Cells_Female_Weak_Repressed_PolyComb	CD4_Memory_Primary_Cells_Repressed_PolyComb
Neurosphere_Cultured_Cells_Ganglionic_Eminence_Derived_Repressed_PolyComb	Rectal_Mucosa.Donor_29_Bivalent_Enhancer
HSMM_Skeletal_Muscle_Myoblasts_Repressed_PolyComb	CD56_Primary_Cells_Bivalent_Enhancer
Brain_Germinal_Matrix_Repressed_PolyComb	HSMMtube_Skeletal_Muscle_Myotubes_Derived_from_HSMM_Enhancers
Penis_Foreskin_Melanocyte_Primary_Cells_skin01_Weak_Repressed_PolyComb	CD14_Primary_Cells_Bivalent_Enhancer
hESC_Derived_CD56pp_Ectoderm_Cultured_Cells_Repressed_PolyComb	Spleen_Weak_transcription
H1_Derived_Mesenchymal_Stem_Cells_Weak_Repressed_PolyComb	ES_I3_Cell_Line_Active_TSS
HSMM_Skeletal_Muscle_Myoblasts_Heterochromatin	Penis_Foreskin_Fibroblast_Primary_Cells_skin01_Enhancers
Fetal_Intestine_Small_Repressed_PolyComb	Osteoblasts_Flanking_Active_TSS
CD4pp_CD25__IL17__PMA_Ionomycin_stimulated_MACS_purified_Th_Primary_Cells_Repressed_PolyComb	Penis_Foreskin_Melanocyte_Primary_Cells_skin03_Enhancers
Pancreatic_Islets_Strong_transcription	Fetal_Heart_Enhancers
CD4pp_CD25__IL17pp_PMA_Ionomcyin_stimulated_Th17_Primary_Cells_Heterochromatin	IMR90_Cell_Line_Enhancers
iPS_15b_Cell_Line_Repressed_PolyComb	Fetal_Kidney_Enhancers
Right_Ventricle_Heterochromatin	Brain_Inferior_Temporal_Lobe_Active_TSS
CD3_Primary_Cells_Peripheral_UW_Repressed_PolyComb	Brain_Mid_Frontal_Lobe_Bivalent_Enhancer
Fetal_Brain_Male_Strong_transcription	iPS_DF_19.11_Cell_Line_Bivalent_Enhancer
Skeletal_Muscle_Female_Heterochromatin	Brain_Cingulate_Gyrus_Flanking_Active_TSS
CD34_Cultured_Cells_Repressed_PolyComb	NHLF_Lung_Fibroblasts_Enhancers
Small_Intestine_Heterochromatin	Rectal_Mucosa.Donor_31_Bivalent_Enhancer
CD4pp_CD25__Th_Primary_Cells_Repressed_PolyComb	Adipose_Derived_Mesenchymal_Stem_Cell_Cultured_Cells_Enhancers
Monocytes_CD14pp_RO01746_ZNF_genes_and_repeats	NHDF_Ad_Adult_Dermal_Fibroblasts_Bivalent_Enhancer
Skeletal_Muscle_Male_Heterochromatin	CD34_Cultured_Cells_Flanking_Active_TSS
Osteoblasts_Heterochromatin	Right_Ventricle_Bivalent_Enhancer
Brain_Angular_Gyrus_Heterochromatin	Thymus_Bivalent_Enhancer
HUES48_Cell_Line_Repressed_PolyComb	Ovary_Enhancers
Fetal_Brain_Male_Heterochromatin	HUES64_Cell_Line_Enhancers
Psoas_Muscle_Strong_transcription	NH_A_Astrocytes_Enhancers
iPS_18_Cell_Line_Repressed_PolyComb	Colon_Smooth_Muscle_Enhancers
CD8_Naive_Primary_Cells_Heterochromatin	Right_Atrium_Enhancers
Breast_vHMEC_Weak_Repressed_PolyComb	HUES48_Cell_Line_Enhancers
Skeletal_Muscle_Female_Repressed_PolyComb	NHDF_Ad_Adult_Dermal_Fibroblasts_Enhancers
Rectal_Smooth_Muscle_Heterochromatin	CD4pp_CD25pp_CD127__Treg_Primary_Cells_Flanking_Active_TSS
Pancreas_Heterochromatin	Osteoblasts_Enhancers
hESC_Derived_CD184pp_Endoderm_Cultured_Cells_ZNF_genes_and_repeats	HUVEC_Umbilical_Vein_Endothelial_Cells_Enhancers
Fetal_Muscle_Leg_Repressed_PolyComb	Fetal_Brain_Female_Flanking_Active_TSS
iPS_20b_Cell_Line_Repressed_PolyComb	H9_Cell_Line_Enhancers
Fetal_Stomach_Repressed_PolyComb	Colonic_Mucosa_Flanking_Active_TSS
Penis_Foreskin_Fibroblast_Primary_Cells_skin02_Repressed_PolyComb	Breast_Myoepithelial_Cells_Flanking_Active_TSS
Stomach_Smooth_Muscle_Weak_Repressed_PolyComb	H9_Cell_Line_Active_TSS
Neurosphere_Cultured_Cells_Cortex_Derived_Weak_Repressed_PolyComb	HSMMtube_Skeletal_Muscle_Myotubes_Derived_from_HSMM_Bivalent_Enhancer
HeLa_S3_Cervical_Carcinoma_Heterochromatin	iPS_15b_Cell_Line_Enhancers
Placenta_Amnion_Weak_Repressed_PolyComb	hESC_Derived_CD184pp_Endoderm_Cultured_Cells_Bivalent_Enhancer
ES_WA7_Cell_Line_Repressed_PolyComb	Chondrocytes_from_Bone_Marrow_Derived_Mesenchymal_Stem_Cell_Cultured_Cells_Enhancers
Aorta_Weak_Repressed_PolyComb	Stomach_Smooth_Muscle_Active_TSS
Adipose_Nuclei_Weak_Repressed_PolyComb	Skeletal_Muscle_Male_Flanking_Bivalent_TSS_Enh
HUES64_Cell_Line_ZNF_genes_and_repeats	CD4pp_CD25__Th_Primary_Cells_Flanking_Active_TSS
Dnd41_TCell_Leukemia_Repressed_PolyComb	Neurosphere_Cultured_Cells_Ganglionic_Eminence_Derived_Bivalent_Enhancer
Stomach_Mucosa_Weak_Repressed_PolyComb	Esophagus_Repressed_PolyComb
Brain_Germinal_Matrix_Weak_Repressed_PolyComb	Adipose_Derived_Mesenchymal_Stem_Cell_Cultured_Cells_Active_TSS
NH_A_Astrocytes_Weak_Repressed_PolyComb	Brain_Angular_Gyrus_Active_TSS
Thymus_Weak_Repressed_PolyComb	CD4pp_CD25__CD45RApp_Naive_Primary_Cells_Flanking_Active_TSS
K562_Leukemia_Repressed_PolyComb	Penis_Foreskin_Fibroblast_Primary_Cells_skin01_Flanking_Bivalent_TSS_Enh
Colon_Smooth_Muscle_Heterochromatin	HUES64_Cell_Line_Active_TSS
CD15_Primary_Cells_Weak_Repressed_PolyComb	Penis_Foreskin_Melanocyte_Primary_Cells_skin01_Flanking_Active_TSS
Placenta_Amnion_Repressed_PolyComb	Mesenchymal_Stem_Cell_Derived_Adipocyte_Cultured_Cells_Enhancers
CD4pp_CD25__IL17pp_PMA_Ionomcyin_stimulated_Th17_Primary_Cells_Repressed_PolyComb	HUES6_Cell_Line_Active_TSS
Fetal_Brain_Female_Weak_Repressed_PolyComb	Brain_Cingulate_Gyrus_Bivalent_Enhancer
H1_BMP4_Derived_Trophoblast_Cultured_Cells_Heterochromatin	Spleen_Heterochromatin
Ovary_Heterochromatin	4star_Weak_transcription
CD56_Primary_Cells_Repressed_PolyComb	iPS_DF_19.11_Cell_Line_Flanking_Active_TSS
Rectal_Mucosa.Donor_31_Repressed_PolyComb	CD4pp_CD25__IL17pp_PMA_Ionomcyin_stimulated_Th17_Primary_Cells_Flanking_Active_TSS
Duodenum_Smooth_Muscle_Repressed_PolyComb	Muscle_Satellite_Cultured_Cells_Enhancers
Duodenum_Smooth_Muscle_Weak_Repressed_PolyComb	Dnd41_TCell_Leukemia_Bivalent_Enhancer
Stomach_Mucosa_Strong_transcription	Brain_Germinal_Matrix_Flanking_Active_TSS
iPS_DF_19.11_Cell_Line_Heterochromatin	CD4_Naive_Primary_Cells_Flanking_Active_TSS
CD4pp_CD25__CD45ROpp_Memory_Primary_Cells_Heterochromatin	NHLF_Lung_Fibroblasts_Bivalent_Enhancer
Bone_Marrow_Derived_Mesenchymal_Stem_Cell_Cultured_Cells_Weak_Repressed_PolyComb	Penis_Foreskin_Melanocyte_Primary_Cells_skin01_Bivalent_Poised_TSS
CD15_Primary_Cells_ZNF_genes_and_repeats	Muscle_Satellite_Cultured_Cells_Flanking_Active_TSS
Colonic_Mucosa_Weak_Repressed_PolyComb	iPS_DF_19.11_Cell_Line_ZNF_genes_and_repeats
Osteoblasts_Weak_Repressed_PolyComb	Bone_Marrow_Derived_Mesenchymal_Stem_Cell_Cultured_Cells_Enhancers
K562_Leukemia_Heterochromatin	A549_EtOH_0.02pct_Lung_Carcinoma_Active_TSS
Duodenum_Mucosa_Repressed_PolyComb	CD19_Primary_Cells_Cord_BI_Flanking_Active_TSS
HUES48_Cell_Line_ZNF_genes_and_repeats	CD8_Memory_Primary_Cells_Flanking_Active_TSS
hESC_Derived_CD56pp_Mesoderm_Cultured_Cells_Active_TSS	4star_Repressed_PolyComb
Ovary_Repressed_PolyComb	Brain_Inferior_Temporal_Lobe_Bivalent_Enhancer
Penis_Foreskin_Keratinocyte_Primary_Cells_skin03_Weak_Repressed_PolyComb	Penis_Foreskin_Melanocyte_Primary_Cells_skin03_Bivalent_Enhancer
Adipose_Nuclei_Repressed_PolyComb	Right_Atrium_Active_TSS
Fetal_Intestine_Small_Weak_Repressed_PolyComb	Rectal_Smooth_Muscle_Enhancers
Stomach_Mucosa_Repressed_PolyComb	Duodenum_Smooth_Muscle_Bivalent_Enhancer
Skeletal_Muscle_Female_Weak_Repressed_PolyComb	Brain_Hippocampus_Middle_Active_TSS
CD4pp_CD25int_CD127pp_Tmem_Primary_Cells_Heterochromatin	Duodenum_Smooth_Muscle_Flanking_Active_TSS
Muscle_Satellite_Cultured_Cells_Weak_Repressed_PolyComb	Lung_Heterochromatin
Neurosphere_Cultured_Cells_Ganglionic_Eminence_Derived_Weak_Repressed_PolyComb	Mobilized_CD34_Primary_Cells_Female_Bivalent_Enhancer
NHDF_Ad_Adult_Dermal_Fibroblasts_Heterochromatin	HUES48_Cell_Line_Active_TSS
CD19_Primary_Cells_Peripheral_UW_Weak_Repressed_PolyComb	Rectal_Smooth_Muscle_Flanking_Active_TSS
Rectal_Mucosa.Donor_29_Repressed_PolyComb	Brain_Cingulate_Gyrus_Active_TSS
HMEC_Mammary_Epithelial_Repressed_PolyComb	Colon_Smooth_Muscle_Flanking_Active_TSS
Penis_Foreskin_Keratinocyte_Primary_Cells_skin02_Weak_Repressed_PolyComb	Fetal_Intestine_Small_Flanking_Active_TSS
H1_Derived_Neuronal_Progenitor_Cultured_Cells_Heterochromatin	Colonic_Mucosa_Active_TSS
CD4_Naive_Primary_Cells_Weak_Repressed_PolyComb	HeLa_S3_Cervical_Carcinoma_Bivalent_Enhancer
CD19_Primary_Cells_Peripheral_UW_Genic_enhancers	Bone_Marrow_Derived_Mesenchymal_Stem_Cell_Cultured_Cells_Flanking_Active_TSS
Colon_Smooth_Muscle_Repressed_PolyComb	iPS_15b_Cell_Line_Bivalent_Poised_TSS
Mobilized_CD34_Primary_Cells_Female_ZNF_genes_and_repeats	Stomach_Smooth_Muscle_Bivalent_Poised_TSS
H1_Derived_Mesenchymal_Stem_Cells_Repressed_PolyComb	HMEC_Mammary_Epithelial_Flanking_Active_TSS
Peripheral_Blood_Mononuclear_Primary_Cells_Repressed_PolyComb	Peripheral_Blood_Mononuclear_Primary_Cells_Bivalent_Enhancer
Small_Intestine_Repressed_PolyComb	NHDF_Ad_Adult_Dermal_Fibroblasts_Flanking_Active_TSS
Brain_Angular_Gyrus_Repressed_PolyComb	CD3_Primary_Cells_Cord_BI_Flanking_Active_TSS
Penis_Foreskin_Melanocyte_Primary_Cells_skin01_Repressed_PolyComb	Mesenchymal_Stem_Cell_Derived_Adipocyte_Cultured_Cells_Flanking_Active_TSS
Pancreatic_Islets_Active_TSS	Bone_Marrow_Derived_Mesenchymal_Stem_Cell_Cultured_Cells_Bivalent_Enhancer
CD4_Memory_Primary_Cells_Heterochromatin	Small_Intestine_Enhancers
NHEK_Epidermal_Keratinocytes_Weak_Repressed_PolyComb	iPS_20b_Cell_Line_Bivalent_Poised_TSS
hESC_Derived_CD56pp_Ectoderm_Cultured_Cells_Active_TSS	CD15_Primary_Cells_Bivalent_Enhancer
iPS_20b_Cell_Line_ZNF_genes_and_repeats	Gastric_Weak_transcription
CD3_Primary_Cells_Peripheral_UW_Genic_enhancers	HSMM_Skeletal_Muscle_Myoblasts_Flanking_Active_TSS
CD4_Naive_Primary_Cells_Heterochromatin	Right_Atrium_Strong_transcription
H1_Cell_Line_Repressed_PolyComb	Fetal_Intestine_Large_Flanking_Active_TSS
Dnd41_TCell_Leukemia_ZNF_genes_and_repeats	CD3_Primary_Cells_Peripheral_UW_Flanking_Active_TSS
Stomach_Mucosa_Heterochromatin	iPS_15b_Cell_Line_Active_TSS
CD4pp_CD25__CD45RApp_Naive_Primary_Cells_Repressed_PolyComb	A549_EtOH_0.02pct_Lung_Carcinoma_Bivalent_Enhancer
H9_Cell_Line_Active_TSS	Brain_Angular_Gyrus_Flanking_Active_TSS
Aorta_Active_TSS	Duodenum_Mucosa_Active_TSS
CD4pp_CD25__IL17__PMA_Ionomycin_stimulated_MACS_purified_Th_Primary_Cells_Genic_enhancers	CD34_Cultured_Cells_Bivalent_Enhancer
Gastric_Heterochromatin	Pancreas_Weak_transcription
Brain_Cingulate_Gyrus_Repressed_PolyComb	CD4_Memory_Primary_Cells_Flanking_Active_TSS
CD4_Memory_Primary_Cells_Weak_Repressed_PolyComb	GM12878_Lymphoblastoid_Active_TSS
CD8_Memory_Primary_Cells_Heterochromatin	hESC_Derived_CD184pp_Endoderm_Cultured_Cells_Active_TSS
CD4pp_CD25__Th_Primary_Cells_Genic_enhancers	Penis_Foreskin_Fibroblast_Primary_Cells_skin01_Bivalent_Poised_TSS
H9_Cell_Line_Repressed_PolyComb	Psoas_Muscle_Active_TSS
ES_I3_Cell_Line_Active_TSS	iPS_20b_Cell_Line_Active_TSS
ES_I3_Cell_Line_Repressed_PolyComb	iPS_18_Cell_Line_Active_TSS
H9_Derived_Neuronal_Progenitor_Cultured_Cells_Weak_Repressed_PolyComb	Penis_Foreskin_Fibroblast_Primary_Cells_skin01_Active_TSS
CD14_Primary_Cells_Enhancers	IMR90_Cell_Line_Flanking_Active_TSS
Brain_Inferior_Temporal_Lobe_Repressed_PolyComb	Penis_Foreskin_Melanocyte_Primary_Cells_skin01_Active_TSS
Brain_Anterior_Caudate_Weak_Repressed_PolyComb	Brain_Substantia_Nigra_Flanking_Active_TSS
ES_WA7_Cell_Line_Strong_transcription	Breast_vHMEC_Bivalent_Enhancer
Fetal_Heart_Weak_Repressed_PolyComb	NH_A_Astrocytes_Bivalent_Enhancer
H9_Derived_Neuron_Cultured_Cells_Weak_Repressed_PolyComb	H1_BMP4_Derived_Trophoblast_Cultured_Cells_Heterochromatin
Psoas_Muscle_Weak_Repressed_PolyComb	HSMM_Skeletal_Muscle_Myoblasts_Bivalent_Enhancer
H9_Derived_Neuronal_Progenitor_Cultured_Cells_ZNF_genes_and_repeats	Mesenchymal_Stem_Cell_Derived_Adipocyte_Cultured_Cells_Active_TSS
Adipose_Derived_Mesenchymal_Stem_Cell_Cultured_Cells_ZNF_genes_and_repeats	H9_Derived_Neuron_Cultured_Cells_Flanking_Active_TSS
CD19_Primary_Cells_Peripheral_UW_ZNF_genes_and_repeats	Adult_Liver_Flanking_Active_TSS
Fetal_Heart_Strong_transcription	iPS_DF_19.11_Cell_Line_Repressed_PolyComb
CD14_Primary_Cells_ZNF_genes_and_repeats	NHLF_Lung_Fibroblasts_Flanking_Active_TSS
GM12878_Lymphoblastoid_ZNF_genes_and_repeats	Fetal_Kidney_Active_TSS
Brain_Hippocampus_Middle_Weak_Repressed_PolyComb	Thymus_Flanking_Active_TSS
CD56_Primary_Cells_Genic_enhancers	CD4pp_CD25__IL17__PMA_Ionomycin_stimulated_MACS_purified_Th_Primary_Cells_Bivalent_Enhancer
CD4pp_CD25__CD45ROpp_Memory_Primary_Cells_Repressed_PolyComb	Bone_Marrow_Derived_Mesenchymal_Stem_Cell_Cultured_Cells_Active_TSS
H1_BMP4_Derived_Mesendoderm_Cultured_Cells_Active_TSS	Brain_Germinal_Matrix_Active_TSS
CD8_Naive_Primary_Cells_Repressed_PolyComb	Right_Ventricle_Active_TSS
Psoas_Muscle_Active_TSS	CD34_Primary_Cells_Flanking_Active_TSS
Brain_Hippocampus_Middle_Repressed_PolyComb	Stomach_Smooth_Muscle_Flanking_Bivalent_TSS_Enh
Brain_Substantia_Nigra_Weak_Repressed_PolyComb	Colon_Smooth_Muscle_Active_TSS
CD19_Primary_Cells_Peripheral_UW_Repressed_PolyComb	Pancreas_Weak_Repressed_PolyComb
HUVEC_Umbilical_Vein_Endothelial_Cells_Weak_Repressed_PolyComb	Psoas_Muscle_Enhancers
Rectal_Smooth_Muscle_Weak_Repressed_PolyComb	Neurosphere_Cultured_Cells_Ganglionic_Eminence_Derived_Flanking_Active_TSS
H1_Cell_Line_Active_TSS	H1_Derived_Neuronal_Progenitor_Cultured_Cells_Weak_transcription
Fetal_Muscle_Leg_Genic_enhancers	iPS_20b_Cell_Line_Enhancers
Adult_Liver_ZNF_genes_and_repeats	GM12878_Lymphoblastoid_Bivalent_Enhancer
iPS_DF_19.11_Cell_Line_Strong_transcription	HUES6_Cell_Line_Flanking_Active_TSS
iPS_DF_6.9_Cell_Line_Repressed_PolyComb	CD4pp_CD25int_CD127pp_Tmem_Primary_Cells_Flanking_Active_TSS
hESC_Derived_CD56pp_Mesoderm_Cultured_Cells_ZNF_genes_and_repeats	CD19_Primary_Cells_Cord_BI_Bivalent_Enhancer
CD8_Memory_Primary_Cells_Weak_Repressed_PolyComb	Rectal_Smooth_Muscle_Bivalent_Enhancer
CD34_Cultured_Cells_ZNF_genes_and_repeats	HUES64_Cell_Line_Bivalent_Poised_TSS
Left_Ventricle_Repressed_PolyComb	CD3_Primary_Cells_Cord_BI_Bivalent_Enhancer
ES_WA7_Cell_Line_Active_TSS	CD8_Naive_Primary_Cells_Flanking_Active_TSS
CD56_Primary_Cells_Weak_Repressed_PolyComb	K562_Leukemia_Weak_transcription
Pancreatic_Islets_Repressed_PolyComb	Fetal_Muscle_Leg_Flanking_Active_TSS
Brain_Inferior_Temporal_Lobe_Weak_Repressed_PolyComb	HSMM_Skeletal_Muscle_Myoblasts_Active_TSS
HUES48_Cell_Line_Active_TSS	CD14_Primary_Cells_Flanking_Active_TSS
CD4pp_CD25__CD45RApp_Naive_Primary_Cells_Genic_enhancers	NHLF_Lung_Fibroblasts_Active_TSS
Fetal_Intestine_Large_Active_TSS	Esophagus_Weak_transcription
HSMMtube_Skeletal_Muscle_Myotubes_Derived_from_HSMM_Weak_Repressed_PolyComb	HSMMtube_Skeletal_Muscle_Myotubes_Derived_from_HSMM_Flanking_Active_TSS
Breast_vHMEC_Active_TSS	Penis_Foreskin_Melanocyte_Primary_Cells_skin03_Flanking_Active_TSS
CD19_Primary_Cells_Cord_BI_ZNF_genes_and_repeats	Fetal_Muscle_Trunk_Flanking_Active_TSS
GM12878_Lymphoblastoid_Repressed_PolyComb	hESC_Derived_CD56pp_Mesoderm_Cultured_Cells_Active_TSS
Fetal_Kidney_Active_TSS	Brain_Anterior_Caudate_Bivalent_Enhancer
ES_WA7_Cell_Line_Heterochromatin	CD19_Primary_Cells_Peripheral_UW_Flanking_Active_TSS
Adult_Liver_Repressed_PolyComb	Penis_Foreskin_Fibroblast_Primary_Cells_skin02_Transcr_at_gene_5_and_3
HUES64_Cell_Line_Active_TSS	Fetal_Thymus_Flanking_Active_TSS
Brain_Substantia_Nigra_Repressed_PolyComb	Sigmoid_Colon_Bivalent_Enhancer
HepG2_Hepatocellular_Carcinoma_Genic_enhancers	CD15_Primary_Cells_Transcr_at_gene_5_and_3
iPS_15b_Cell_Line_Active_TSS	HUVEC_Umbilical_Vein_Endothelial_Cells_Bivalent_Enhancer
CD4pp_CD25int_CD127pp_Tmem_Primary_Cells_Weak_Repressed_PolyComb	Breast_Myoepithelial_Cells_Active_TSS
CD4pp_CD25__CD45RApp_Naive_Primary_Cells_Weak_Repressed_PolyComb	Penis_Foreskin_Keratinocyte_Primary_Cells_skin03_Active_TSS
H1_BMP4_Derived_Trophoblast_Cultured_Cells_Repressed_PolyComb	H1_BMP4_Derived_Mesendoderm_Cultured_Cells_Enhancers
Neurosphere_Cultured_Cells_Ganglionic_Eminence_Derived_ZNF_genes_and_repeats	Spleen_ZNF_genes_and_repeats
CD3_Primary_Cells_Cord_BI_ZNF_genes_and_repeats	CD56_Primary_Cells_Flanking_Active_TSS
Breast_vHMEC_Repressed_PolyComb	Monocytes_CD14pp_RO01746_Transcr_at_gene_5_and_3
Left_Ventricle_Active_TSS	Stomach_Mucosa_Flanking_Active_TSS
Fetal_Intestine_Large_Weak_Repressed_PolyComb	Breast_Myoepithelial_Cells_Weak_transcription
Right_Ventricle_Repressed_PolyComb	CD4pp_CD25pp_CD127__Treg_Primary_Cells_Bivalent_Enhancer
Mesenchymal_Stem_Cell_Derived_Adipocyte_Cultured_Cells_ZNF_genes_and_repeats	H1_Cell_Line_Active_TSS
HSMMtube_Skeletal_Muscle_Myotubes_Derived_from_HSMM_Active_TSS	Brain_Substantia_Nigra_Active_TSS
Dnd41_TCell_Leukemia_Genic_enhancers	HepG2_Hepatocellular_Carcinoma_Active_TSS
CD3_Primary_Cells_Peripheral_UW_ZNF_genes_and_repeats	HeLa_S3_Cervical_Carcinoma_Bivalent_Poised_TSS
4star_Repressed_PolyComb	H9_Derived_Neuronal_Progenitor_Cultured_Cells_Active_TSS
Neurosphere_Cultured_Cells_Cortex_Derived_ZNF_genes_and_repeats	Lung_Weak_transcription
HUES6_Cell_Line_Active_TSS	Fetal_Adrenal_Gland_Flanking_Active_TSS
Brain_Anterior_Caudate_Repressed_PolyComb	ES_I3_Cell_Line_Bivalent_Poised_TSS
Brain_Mid_Frontal_Lobe_Weak_Repressed_PolyComb	Skeletal_Muscle_Male_Bivalent_Poised_TSS
CD34_Primary_Cells_Weak_Repressed_PolyComb	iPS_15b_Cell_Line_Flanking_Bivalent_TSS_Enh
CD4pp_CD25pp_CD127__Treg_Primary_Cells_ZNF_genes_and_repeats	Fetal_Intestine_Small_Genic_enhancers
NHLF_Lung_Fibroblasts_Active_TSS	HeLa_S3_Cervical_Carcinoma_Active_TSS
Ovary_Active_TSS	Penis_Foreskin_Keratinocyte_Primary_Cells_skin02_Active_TSS
Dnd41_TCell_Leukemia_Transcr_at_gene_5_and_3	H9_Cell_Line_Repressed_PolyComb
NHDF_Ad_Adult_Dermal_Fibroblasts_Weak_Repressed_PolyComb	iPS_DF_6.9_Cell_Line_Weak_transcription
CD4pp_CD25pp_CD127__Treg_Primary_Cells_Genic_enhancers	Lung_Bivalent_Enhancer
Fetal_Brain_Female_ZNF_genes_and_repeats	CD4pp_CD25__CD45ROpp_Memory_Primary_Cells_Flanking_Active_TSS
CD4pp_CD25__Th_Primary_Cells_ZNF_genes_and_repeats	Thymus_Active_TSS
Fetal_Intestine_Small_Genic_enhancers	Brain_Angular_Gyrus_Bivalent_Enhancer
iPS_DF_6.9_Cell_Line_Active_TSS	Neurosphere_Cultured_Cells_Ganglionic_Eminence_Derived_Active_TSS
Fetal_Thymus_Genic_enhancers	Fetal_Kidney_Flanking_Bivalent_TSS_Enh
Fetal_Adrenal_Gland_Genic_enhancers	Fetal_Heart_Bivalent_Enhancer
NHDF_Ad_Adult_Dermal_Fibroblasts_Active_TSS	NHDF_Ad_Adult_Dermal_Fibroblasts_Active_TSS
Breast_Myoepithelial_Cells_Enhancers	CD4pp_CD25__IL17pp_PMA_Ionomcyin_stimulated_Th17_Primary_Cells_Bivalent_Enhancer
iPS_18_Cell_Line_ZNF_genes_and_repeats	Fetal_Lung_Flanking_Active_TSS
Fetal_Placenta_Genic_enhancers	HSMMtube_Skeletal_Muscle_Myotubes_Derived_from_HSMM_Active_TSS
Right_Ventricle_Weak_Repressed_PolyComb	Fetal_Muscle_Trunk_Flanking_Bivalent_TSS_Enh
Fetal_Placenta_Repressed_PolyComb	Fetal_Brain_Male_Bivalent_Poised_TSS
CD19_Primary_Cells_Peripheral_UW_Enhancers	Aorta_Enhancers
Duodenum_Mucosa_Weak_Repressed_PolyComb	K562_Leukemia_Active_TSS
CD34_Primary_Cells_ZNF_genes_and_repeats	HUVEC_Umbilical_Vein_Endothelial_Cells_Flanking_Active_TSS
Adipose_Nuclei_ZNF_genes_and_repeats	H9_Derived_Neuronal_Progenitor_Cultured_Cells_Flanking_Active_TSS
hESC_Derived_CD184pp_Endoderm_Cultured_Cells_Active_TSS	CD14_Primary_Cells_Transcr_at_gene_5_and_3
Bone_Marrow_Derived_Mesenchymal_Stem_Cell_Cultured_Cells_ZNF_genes_and_repeats	H1_BMP4_Derived_Trophoblast_Cultured_Cells_Weak_transcription
CD3_Primary_Cells_Peripheral_UW_Weak_Repressed_PolyComb	NH_A_Astrocytes_Flanking_Active_TSS
CD8_Naive_Primary_Cells_ZNF_genes_and_repeats	Fetal_Placenta_Weak_transcription
Fetal_Heart_Enhancers	Left_Ventricle_Bivalent_Enhancer
Brain_Mid_Frontal_Lobe_Repressed_PolyComb	iPS_DF_6.9_Cell_Line_Repressed_PolyComb
IMR90_Cell_Line_Active_TSS	4star_Bivalent_Enhancer
Rectal_Smooth_Muscle_Repressed_PolyComb	CD19_Primary_Cells_Cord_BI_Transcr_at_gene_5_and_3
HUES6_Cell_Line_ZNF_genes_and_repeats	HUES6_Cell_Line_Bivalent_Poised_TSS
Adipose_Derived_Mesenchymal_Stem_Cell_Cultured_Cells_Active_TSS	Fetal_Intestine_Small_Transcr_at_gene_5_and_3
Duodenum_Mucosa_ZNF_genes_and_repeats	Right_Atrium_ZNF_genes_and_repeats
Brain_Cingulate_Gyrus_Weak_Repressed_PolyComb	Right_Atrium_Genic_enhancers
Adult_Liver_Genic_enhancers	Aorta_Heterochromatin
Fetal_Muscle_Trunk_Genic_enhancers	H1_Derived_Mesenchymal_Stem_Cells_Weak_transcription
CD8_Naive_Primary_Cells_Transcr_at_gene_5_and_3	Penis_Foreskin_Fibroblast_Primary_Cells_skin01_Transcr_at_gene_5_and_3
NHLF_Lung_Fibroblasts_Weak_Repressed_PolyComb	Left_Ventricle_Active_TSS
Breast_Myoepithelial_Cells_Genic_enhancers	Rectal_Mucosa.Donor_31_Active_TSS
A549_EtOH_0.02pct_Lung_Carcinoma_Active_TSS	HeLa_S3_Cervical_Carcinoma_Flanking_Bivalent_TSS_Enh
CD4pp_CD25__CD45RApp_Naive_Primary_Cells_ZNF_genes_and_repeats	Esophagus_Bivalent_Enhancer
CD19_Primary_Cells_Cord_BI_Genic_enhancers	Pancreatic_Islets_Flanking_Active_TSS
Brain_Angular_Gyrus_Weak_Repressed_PolyComb	Ovary_Active_TSS
iPS_18_Cell_Line_Active_TSS	Fetal_Kidney_Flanking_Active_TSS
HMEC_Mammary_Epithelial_Enhancers	Aorta_Active_TSS
Fetal_Intestine_Small_Active_TSS	Chondrocytes_from_Bone_Marrow_Derived_Mesenchymal_Stem_Cell_Cultured_Cells_Active_TSS
HUVEC_Umbilical_Vein_Endothelial_Cells_Genic_enhancers	Breast_Myoepithelial_Cells_Bivalent_Poised_TSS
CD56_Primary_Cells_ZNF_genes_and_repeats	Brain_Substantia_Nigra_Bivalent_Enhancer
A549_EtOH_0.02pct_Lung_Carcinoma_ZNF_genes_and_repeats	Fetal_Heart_Flanking_Active_TSS
CD4_Memory_Primary_Cells_Genic_enhancers	Mobilized_CD34_Primary_Cells_Male_Bivalent_Poised_TSS
Brain_Angular_Gyrus_Active_TSS	Osteoblasts_Active_TSS
CD4pp_CD25__IL17__PMA_Ionomycin_stimulated_MACS_purified_Th_Primary_Cells_ZNF_genes_and_repeats	Brain_Mid_Frontal_Lobe_Weak_transcription
CD4pp_CD25__Th_Primary_Cells_Enhancers	Ovary_Flanking_Active_TSS
Fetal_Intestine_Large_Enhancers	Spleen_Genic_enhancers
CD15_Primary_Cells_Genic_enhancers	Penis_Foreskin_Melanocyte_Primary_Cells_skin01_Weak_transcription
Fetal_Heart_Heterochromatin	Colon_Smooth_Muscle_Bivalent_Enhancer
Penis_Foreskin_Melanocyte_Primary_Cells_skin03_Weak_Repressed_PolyComb	Mobilized_CD34_Primary_Cells_Male_Flanking_Bivalent_TSS_Enh
HepG2_Hepatocellular_Carcinoma_Enhancers	ES_WA7_Cell_Line_Flanking_Active_TSS
Breast_Myoepithelial_Cells_Active_TSS	Fetal_Intestine_Large_Active_TSS
CD34_Cultured_Cells_Weak_Repressed_PolyComb	Esophagus_Flanking_Active_TSS
Mobilized_CD34_Primary_Cells_Female_Enhancers	Small_Intestine_Bivalent_Enhancer
Fetal_Stomach_Genic_enhancers	Esophagus_Transcr_at_gene_5_and_3
Skeletal_Muscle_Male_Genic_enhancers	Right_Ventricle_Weak_transcription
Fetal_Stomach_Active_TSS	Penis_Foreskin_Keratinocyte_Primary_Cells_skin03_Weak_transcription
CD4_Naive_Primary_Cells_Genic_enhancers	Right_Ventricle_Flanking_Active_TSS
Fetal_Kidney_Heterochromatin	Skeletal_Muscle_Male_Active_TSS
CD3_Primary_Cells_Cord_BI_Genic_enhancers	CD4pp_CD25__Th_Primary_Cells_Bivalent_Enhancer
Skeletal_Muscle_Female_Genic_enhancers	Penis_Foreskin_Melanocyte_Primary_Cells_skin01_Flanking_Bivalent_TSS_Enh
Breast_vHMEC_Enhancers	Brain_Anterior_Caudate_Weak_transcription
H9_Derived_Neuronal_Progenitor_Cultured_Cells_Active_TSS	Adipose_Nuclei_Bivalent_Poised_TSS
CD34_Cultured_Cells_Genic_enhancers	CD4pp_CD25int_CD127pp_Tmem_Primary_Cells_Active_TSS
CD15_Primary_Cells_Enhancers	CD34_Cultured_Cells_Weak_transcription
CD4pp_CD25__CD45ROpp_Memory_Primary_Cells_Genic_enhancers	Duodenum_Mucosa_Flanking_Bivalent_TSS_Enh
Brain_Mid_Frontal_Lobe_Active_TSS	Aorta_Transcr_at_gene_5_and_3
K562_Leukemia_Active_TSS	Neurosphere_Cultured_Cells_Cortex_Derived_Flanking_Active_TSS
CD4_Memory_Primary_Cells_Enhancers	Pancreatic_Islets_Bivalent_Enhancer
Brain_Germinal_Matrix_ZNF_genes_and_repeats	Mobilized_CD34_Primary_Cells_Female_Weak_transcription
iPS_20b_Cell_Line_Active_TSS	CD34_Primary_Cells_Bivalent_Enhancer
Duodenum_Smooth_Muscle_ZNF_genes_and_repeats	Left_Ventricle_Flanking_Active_TSS
Adipose_Derived_Mesenchymal_Stem_Cell_Cultured_Cells_Enhancers	Right_Atrium_Flanking_Active_TSS
Breast_Myoepithelial_Cells_ZNF_genes_and_repeats	K562_Leukemia_Flanking_Bivalent_TSS_Enh
HSMM_Skeletal_Muscle_Myoblasts_Active_TSS	A549_EtOH_0.02pct_Lung_Carcinoma_Weak_transcription
Sigmoid_Colon_Active_TSS	H1_Derived_Mesenchymal_Stem_Cells_Flanking_Active_TSS
NHDF_Ad_Adult_Dermal_Fibroblasts_Enhancers	Adipose_Derived_Mesenchymal_Stem_Cell_Cultured_Cells_Flanking_Bivalent_TSS_Enh
Small_Intestine_Active_TSS	Left_Ventricle_Transcr_at_gene_5_and_3
Colon_Smooth_Muscle_Active_TSS	Penis_Foreskin_Melanocyte_Primary_Cells_skin01_Transcr_at_gene_5_and_3
CD8_Naive_Primary_Cells_Enhancers	Duodenum_Mucosa_Weak_transcription
CD4pp_CD25__IL17__PMA_Ionomycin_stimulated_MACS_purified_Th_Primary_Cells_Transcr_at_gene_5_and_3	Fetal_Stomach_Genic_enhancers
CD4pp_CD25__IL17pp_PMA_Ionomcyin_stimulated_Th17_Primary_Cells_Genic_enhancers	CD4pp_CD25__CD45RApp_Naive_Primary_Cells_Bivalent_Enhancer
Fetal_Muscle_Trunk_Repressed_PolyComb	Penis_Foreskin_Keratinocyte_Primary_Cells_skin02_Transcr_at_gene_5_and_3
Duodenum_Smooth_Muscle_Active_TSS	CD19_Primary_Cells_Peripheral_UW_Transcr_at_gene_5_and_3
Sigmoid_Colon_Repressed_PolyComb	Skeletal_Muscle_Female_Active_TSS
Penis_Foreskin_Melanocyte_Primary_Cells_skin03_Genic_enhancers	Fetal_Thymus_Transcr_at_gene_5_and_3
Fetal_Muscle_Leg_Enhancers	CD3_Primary_Cells_Peripheral_UW_Transcr_at_gene_5_and_3
Fetal_Intestine_Small_Enhancers	CD19_Primary_Cells_Cord_BI_Bivalent_Poised_TSS
hESC_Derived_CD56pp_Mesoderm_Cultured_Cells_Genic_enhancers	Penis_Foreskin_Keratinocyte_Primary_Cells_skin03_Transcr_at_gene_5_and_3
Fetal_Muscle_Leg_ZNF_genes_and_repeats	Thymus_Transcr_at_gene_5_and_3
Colonic_Mucosa_Repressed_PolyComb	NHDF_Ad_Adult_Dermal_Fibroblasts_Transcr_at_gene_5_and_3
Rectal_Mucosa.Donor_29_ZNF_genes_and_repeats	Rectal_Smooth_Muscle_Bivalent_Poised_TSS
Fetal_Thymus_Enhancers	Rectal_Mucosa.Donor_29_Bivalent_Poised_TSS
CD34_Cultured_Cells_Enhancers	Duodenum_Smooth_Muscle_Bivalent_Poised_TSS
H1_Cell_Line_ZNF_genes_and_repeats	CD3_Primary_Cells_Peripheral_UW_Flanking_Bivalent_TSS_Enh
HSMM_Skeletal_Muscle_Myoblasts_Genic_enhancers	Fetal_Stomach_Flanking_Active_TSS
Neurosphere_Cultured_Cells_Cortex_Derived_Enhancers	iPS_15b_Cell_Line_Flanking_Active_TSS
CD4pp_CD25__CD45ROpp_Memory_Primary_Cells_ZNF_genes_and_repeats	Adipose_Nuclei_Active_TSS
Fetal_Muscle_Trunk_ZNF_genes_and_repeats	Brain_Cingulate_Gyrus_Bivalent_Poised_TSS
H1_Derived_Neuronal_Progenitor_Cultured_Cells_Active_TSS	Stomach_Smooth_Muscle_Transcr_at_gene_5_and_3
Penis_Foreskin_Fibroblast_Primary_Cells_skin01_Genic_enhancers	Right_Atrium_Bivalent_Enhancer
CD4pp_CD25int_CD127pp_Tmem_Primary_Cells_Repressed_PolyComb	ES_I3_Cell_Line_Flanking_Active_TSS
CD14_Primary_Cells_Genic_enhancers	H9_Derived_Neuron_Cultured_Cells_Active_TSS
Adipose_Derived_Mesenchymal_Stem_Cell_Cultured_Cells_Genic_enhancers	CD8_Memory_Primary_Cells_Bivalent_Enhancer
CD4pp_CD25__IL17__PMA_Ionomycin_stimulated_MACS_purified_Th_Primary_Cells_Enhancers	CD3_Primary_Cells_Cord_BI_Active_TSS
Brain_Substantia_Nigra_Active_TSS	Monocytes_CD14pp_RO01746_Flanking_Bivalent_TSS_Enh
NHEK_Epidermal_Keratinocytes_Genic_enhancers	Mobilized_CD34_Primary_Cells_Male_Weak_transcription
Chondrocytes_from_Bone_Marrow_Derived_Mesenchymal_Stem_Cell_Cultured_Cells_ZNF_genes_and_repeats	GM12878_Lymphoblastoid_Heterochromatin
K562_Leukemia_Genic_enhancers	Fetal_Lung_Bivalent_Poised_TSS
Right_Atrium_Active_TSS	Adipose_Derived_Mesenchymal_Stem_Cell_Cultured_Cells_Bivalent_Poised_TSS
CD4pp_CD25__CD45ROpp_Memory_Primary_Cells_Enhancers	ES_I3_Cell_Line_Flanking_Bivalent_TSS_Enh
Fetal_Adrenal_Gland_Enhancers	Brain_Inferior_Temporal_Lobe_Weak_transcription
Muscle_Satellite_Cultured_Cells_Genic_enhancers	Skeletal_Muscle_Female_Flanking_Bivalent_TSS_Enh
CD19_Primary_Cells_Cord_BI_Weak_Repressed_PolyComb	Lung_Transcr_at_gene_5_and_3
CD8_Memory_Primary_Cells_Repressed_PolyComb	HUES6_Cell_Line_Flanking_Bivalent_TSS_Enh
CD3_Primary_Cells_Peripheral_UW_Enhancers	Skeletal_Muscle_Male_Transcr_at_gene_5_and_3
Penis_Foreskin_Melanocyte_Primary_Cells_skin03_Enhancers	CD4pp_CD25__CD45ROpp_Memory_Primary_Cells_Transcr_at_gene_5_and_3
Right_Ventricle_Active_TSS	HMEC_Mammary_Epithelial_Weak_transcription
CD4pp_CD25__CD45RApp_Naive_Primary_Cells_Enhancers	Spleen_Transcr_at_gene_5_and_3
Rectal_Mucosa.Donor_31_Weak_Repressed_PolyComb	Penis_Foreskin_Melanocyte_Primary_Cells_skin03_Active_TSS
Adult_Liver_Enhancers	Fetal_Kidney_Bivalent_Poised_TSS
HUVEC_Umbilical_Vein_Endothelial_Cells_Enhancers	Fetal_Brain_Male_Flanking_Active_TSS
A549_EtOH_0.02pct_Lung_Carcinoma_Genic_enhancers	Adult_Liver_Weak_transcription
CD8_Naive_Primary_Cells_Genic_enhancers	Peripheral_Blood_Mononuclear_Primary_Cells_Transcr_at_gene_5_and_3
4star_Active_TSS	Muscle_Satellite_Cultured_Cells_Active_TSS
Fetal_Intestine_Large_Genic_enhancers	Adipose_Derived_Mesenchymal_Stem_Cell_Cultured_Cells_Transcr_at_gene_5_and_3
Penis_Foreskin_Melanocyte_Primary_Cells_skin01_Active_TSS	IMR90_Cell_Line_Transcr_at_gene_5_and_3
CD56_Primary_Cells_Enhancers	Fetal_Placenta_Flanking_Active_TSS
HMEC_Mammary_Epithelial_ZNF_genes_and_repeats	Fetal_Intestine_Large_Transcr_at_gene_5_and_3
CD4_Memory_Primary_Cells_Repressed_PolyComb	Skeletal_Muscle_Female_Bivalent_Poised_TSS
H9_Derived_Neuron_Cultured_Cells_Enhancers	Adipose_Nuclei_Transcr_at_gene_5_and_3
Penis_Foreskin_Keratinocyte_Primary_Cells_skin03_ZNF_genes_and_repeats	hESC_Derived_CD56pp_Ectoderm_Cultured_Cells_Active_TSS
CD4_Naive_Primary_Cells_Repressed_PolyComb	CD4pp_CD25int_CD127pp_Tmem_Primary_Cells_Transcr_at_gene_5_and_3
Small_Intestine_ZNF_genes_and_repeats	HMEC_Mammary_Epithelial_Active_TSS
Peripheral_Blood_Mononuclear_Primary_Cells_Weak_Repressed_PolyComb	CD56_Primary_Cells_Transcr_at_gene_5_and_3
Left_Ventricle_Weak_Repressed_PolyComb	H1_Derived_Mesenchymal_Stem_Cells_Flanking_Bivalent_TSS_Enh
Brain_Anterior_Caudate_Active_TSS	hESC_Derived_CD184pp_Endoderm_Cultured_Cells_Flanking_Active_TSS
Fetal_Intestine_Small_ZNF_genes_and_repeats	Penis_Foreskin_Keratinocyte_Primary_Cells_skin02_Weak_transcription
A549_EtOH_0.02pct_Lung_Carcinoma_Weak_Repressed_PolyComb	CD4pp_CD25__Th_Primary_Cells_Transcr_at_gene_5_and_3
Penis_Foreskin_Keratinocyte_Primary_Cells_skin03_Genic_enhancers	Peripheral_Blood_Mononuclear_Primary_Cells_Flanking_Active_TSS
Mobilized_CD34_Primary_Cells_Female_Genic_enhancers	Pancreas_Flanking_Active_TSS
Breast_Myoepithelial_Cells_Transcr_at_gene_5_and_3	Duodenum_Mucosa_Bivalent_Poised_TSS
Lung_Active_TSS	Colonic_Mucosa_Flanking_Bivalent_TSS_Enh
HepG2_Hepatocellular_Carcinoma_ZNF_genes_and_repeats	CD8_Naive_Primary_Cells_Transcr_at_gene_5_and_3
Brain_Cingulate_Gyrus_Active_TSS	Esophagus_Active_TSS
Thymus_Active_TSS	HUES48_Cell_Line_Bivalent_Poised_TSS
Stomach_Mucosa_Active_TSS	Monocytes_CD14pp_RO01746_Bivalent_Poised_TSS
HSMM_Skeletal_Muscle_Myoblasts_Weak_Repressed_PolyComb	Fetal_Intestine_Small_Active_TSS
hESC_Derived_CD56pp_Mesoderm_Cultured_Cells_Enhancers	HMEC_Mammary_Epithelial_Transcr_at_gene_5_and_3
CD8_Naive_Primary_Cells_Weak_Repressed_PolyComb	Penis_Foreskin_Fibroblast_Primary_Cells_skin02_Genic_enhancers
Peripheral_Blood_Mononuclear_Primary_Cells_ZNF_genes_and_repeats	Breast_Myoepithelial_Cells_Flanking_Bivalent_TSS_Enh
CD8_Memory_Primary_Cells_Genic_enhancers	Penis_Foreskin_Melanocyte_Primary_Cells_skin03_Transcr_at_gene_5_and_3
Fetal_Intestine_Large_ZNF_genes_and_repeats	HMEC_Mammary_Epithelial_Bivalent_Enhancer
Penis_Foreskin_Melanocyte_Primary_Cells_skin03_ZNF_genes_and_repeats	NHEK_Epidermal_Keratinocytes_Transcr_at_gene_5_and_3
HMEC_Mammary_Epithelial_Genic_enhancers	H1_BMP4_Derived_Mesendoderm_Cultured_Cells_Bivalent_Enhancer
Esophagus_Active_TSS	Fetal_Adrenal_Gland_Bivalent_Poised_TSS
Rectal_Mucosa.Donor_29_Weak_Repressed_PolyComb	Peripheral_Blood_Mononuclear_Primary_Cells_Active_TSS
Rectal_Smooth_Muscle_Active_TSS	IMR90_Cell_Line_Active_TSS
Colonic_Mucosa_ZNF_genes_and_repeats	CD4pp_CD25pp_CD127__Treg_Primary_Cells_Active_TSS
Penis_Foreskin_Keratinocyte_Primary_Cells_skin02_ZNF_genes_and_repeats	Right_Ventricle_Transcr_at_gene_5_and_3
iPS_DF_19.11_Cell_Line_Repressed_PolyComb	Mobilized_CD34_Primary_Cells_Male_Transcr_at_gene_5_and_3
IMR90_Cell_Line_Genic_enhancers	CD4_Naive_Primary_Cells_Transcr_at_gene_5_and_3
CD3_Primary_Cells_Cord_BI_Enhancers	iPS_18_Cell_Line_Bivalent_Poised_TSS
Fetal_Placenta_Enhancers	Placenta_Amnion_Weak_transcription
CD4pp_CD25int_CD127pp_Tmem_Primary_Cells_ZNF_genes_and_repeats	iPS_DF_19.11_Cell_Line_Transcr_at_gene_5_and_3
Pancreatic_Islets_ZNF_genes_and_repeats	Spleen_Flanking_Active_TSS
NHLF_Lung_Fibroblasts_Genic_enhancers	Adipose_Nuclei_Flanking_Bivalent_TSS_Enh
Penis_Foreskin_Fibroblast_Primary_Cells_skin01_ZNF_genes_and_repeats	Brain_Anterior_Caudate_Bivalent_Poised_TSS
Brain_Inferior_Temporal_Lobe_Active_TSS	Fetal_Muscle_Leg_Transcr_at_gene_5_and_3
Skeletal_Muscle_Male_ZNF_genes_and_repeats	hESC_Derived_CD56pp_Mesoderm_Cultured_Cells_Weak_transcription
NHEK_Epidermal_Keratinocytes_Active_TSS	CD34_Cultured_Cells_Transcr_at_gene_5_and_3
CD19_Primary_Cells_Cord_BI_Enhancers	Brain_Anterior_Caudate_Transcr_at_gene_5_and_3
Rectal_Mucosa.Donor_31_ZNF_genes_and_repeats	Psoas_Muscle_Flanking_Active_TSS
NHDF_Ad_Adult_Dermal_Fibroblasts_Genic_enhancers	Fetal_Brain_Female_Transcr_at_gene_5_and_3
Penis_Foreskin_Keratinocyte_Primary_Cells_skin03_Enhancers	Pancreas_Transcr_at_gene_5_and_3
Brain_Hippocampus_Middle_Active_TSS	Brain_Cingulate_Gyrus_Transcr_at_gene_5_and_3
Fetal_Adrenal_Gland_ZNF_genes_and_repeats	Fetal_Brain_Female_Weak_transcription
H9_Derived_Neuronal_Progenitor_Cultured_Cells_Enhancers	Aorta_Flanking_Active_TSS
Fetal_Brain_Female_Active_TSS	Brain_Hippocampus_Middle_Transcr_at_gene_5_and_3
NHDF_Ad_Adult_Dermal_Fibroblasts_ZNF_genes_and_repeats	K562_Leukemia_Bivalent_Poised_TSS
HeLa_S3_Cervical_Carcinoma_Active_TSS	Fetal_Brain_Male_Active_TSS
Adipose_Nuclei_Genic_enhancers	Placenta_Amnion_Bivalent_Enhancer
Stomach_Mucosa_Enhancers	Fetal_Lung_Active_TSS
ES_I3_Cell_Line_Bivalent_Poised_TSS	Adult_Liver_Bivalent_Poised_TSS
CD4_Naive_Primary_Cells_Enhancers	Spleen_Repressed_PolyComb
Fetal_Lung_Active_TSS	CD8_Naive_Primary_Cells_Bivalent_Enhancer
Chondrocytes_from_Bone_Marrow_Derived_Mesenchymal_Stem_Cell_Cultured_Cells_Genic_enhancers	Breast_vHMEC_Transcr_at_gene_5_and_3
CD4pp_CD25__CD45ROpp_Memory_Primary_Cells_Weak_Repressed_PolyComb	Gastric_Repressed_PolyComb
NHEK_Epidermal_Keratinocytes_Enhancers	Skeletal_Muscle_Female_Transcr_at_gene_5_and_3
Penis_Foreskin_Keratinocyte_Primary_Cells_skin02_Genic_enhancers	NHLF_Lung_Fibroblasts_Transcr_at_gene_5_and_3
Fetal_Muscle_Trunk_Active_TSS	Pancreatic_Islets_Enhancers
CD4pp_CD25__IL17pp_PMA_Ionomcyin_stimulated_Th17_Primary_Cells_Weak_Repressed_PolyComb	Mesenchymal_Stem_Cell_Derived_Adipocyte_Cultured_Cells_Transcr_at_gene_5_and_3
H1_BMP4_Derived_Mesendoderm_Cultured_Cells_Strong_transcription	H9_Derived_Neuronal_Progenitor_Cultured_Cells_Weak_transcription
Fetal_Lung_Enhancers	Placenta_Amnion_Transcr_at_gene_5_and_3
CD3_Primary_Cells_Cord_BI_Weak_Repressed_PolyComb	Brain_Hippocampus_Middle_Bivalent_Poised_TSS
GM12878_Lymphoblastoid_Genic_enhancers	H1_Cell_Line_Flanking_Active_TSS
Placenta_Amnion_Active_TSS	Fetal_Placenta_Transcr_at_gene_5_and_3
Osteoblasts_Genic_enhancers	CD8_Memory_Primary_Cells_Transcr_at_gene_5_and_3
Bone_Marrow_Derived_Mesenchymal_Stem_Cell_Cultured_Cells_Active_TSS	Rectal_Mucosa.Donor_31_Transcr_at_gene_5_and_3
CD4pp_CD25__IL17pp_PMA_Ionomcyin_stimulated_Th17_Primary_Cells_ZNF_genes_and_repeats	CD4pp_CD25__IL17__PMA_Ionomycin_stimulated_MACS_purified_Th_Primary_Cells_Transcr_at_gene_5_and_3
Colon_Smooth_Muscle_Genic_enhancers	Fetal_Adrenal_Gland_Flanking_Bivalent_TSS_Enh
Fetal_Muscle_Leg_Active_TSS	CD4_Memory_Primary_Cells_Transcr_at_gene_5_and_3
4star_ZNF_genes_and_repeats	Breast_Myoepithelial_Cells_Transcr_at_gene_5_and_3
Stomach_Mucosa_Genic_enhancers	Colon_Smooth_Muscle_Transcr_at_gene_5_and_3
HMEC_Mammary_Epithelial_Active_TSS	Osteoblasts_Bivalent_Poised_TSS
IMR90_Cell_Line_ZNF_genes_and_repeats	ES_WA7_Cell_Line_Active_TSS
Dnd41_TCell_Leukemia_Enhancers	Brain_Inferior_Temporal_Lobe_Transcr_at_gene_5_and_3
CD8_Memory_Primary_Cells_Enhancers	CD3_Primary_Cells_Cord_BI_Transcr_at_gene_5_and_3
Penis_Foreskin_Keratinocyte_Primary_Cells_skin02_Enhancers	Osteoblasts_Transcr_at_gene_5_and_3
iPS_15b_Cell_Line_ZNF_genes_and_repeats	Brain_Cingulate_Gyrus_Weak_transcription
HSMM_Skeletal_Muscle_Myoblasts_Enhancers	Brain_Mid_Frontal_Lobe_Transcr_at_gene_5_and_3
Fetal_Placenta_ZNF_genes_and_repeats	Bone_Marrow_Derived_Mesenchymal_Stem_Cell_Cultured_Cells_Transcr_at_gene_5_and_3
GM12878_Lymphoblastoid_Active_TSS	Stomach_Mucosa_Transcr_at_gene_5_and_3
CD8_Memory_Primary_Cells_Active_TSS	HSMM_Skeletal_Muscle_Myoblasts_Transcr_at_gene_5_and_3
Brain_Hippocampus_Middle_Genic_enhancers	Ovary_Transcr_at_gene_5_and_3
CD34_Primary_Cells_Enhancers	NH_A_Astrocytes_Active_TSS
Neurosphere_Cultured_Cells_Cortex_Derived_Genic_enhancers	Colonic_Mucosa_Weak_transcription
CD4pp_CD25int_CD127pp_Tmem_Primary_Cells_Genic_enhancers	Ovary_Bivalent_Enhancer
Penis_Foreskin_Fibroblast_Primary_Cells_skin01_Enhancers	NHEK_Epidermal_Keratinocytes_Active_TSS
Fetal_Adrenal_Gland_Active_TSS	Rectal_Mucosa.Donor_29_Weak_transcription
Esophagus_Repressed_PolyComb	Pancreas_Bivalent_Poised_TSS
Chondrocytes_from_Bone_Marrow_Derived_Mesenchymal_Stem_Cell_Cultured_Cells_Enhancers	Chondrocytes_from_Bone_Marrow_Derived_Mesenchymal_Stem_Cell_Cultured_Cells_Transcr_at_gene_5_and_3
Fetal_Brain_Male_Enhancers	Brain_Germinal_Matrix_Genic_enhancers
CD4pp_CD25__IL17pp_PMA_Ionomcyin_stimulated_Th17_Primary_Cells_Transcr_at_gene_5_and_3	CD14_Primary_Cells_Genic_enhancers
Stomach_Smooth_Muscle_Genic_enhancers	CD4pp_CD25__CD45ROpp_Memory_Primary_Cells_Bivalent_Enhancer
H1_Derived_Neuronal_Progenitor_Cultured_Cells_Repressed_PolyComb	Spleen_Bivalent_Poised_TSS
Pancreas_Active_TSS	Chondrocytes_from_Bone_Marrow_Derived_Mesenchymal_Stem_Cell_Cultured_Cells_Weak_transcription
Mobilized_CD34_Primary_Cells_Male_Flanking_Active_TSS	Fetal_Muscle_Trunk_Transcr_at_gene_5_and_3
Fetal_Stomach_Enhancers	H9_Cell_Line_Bivalent_Enhancer
Mobilized_CD34_Primary_Cells_Male_Genic_enhancers	Brain_Inferior_Temporal_Lobe_Bivalent_Poised_TSS
HUES64_Cell_Line_Bivalent_Poised_TSS	H1_BMP4_Derived_Trophoblast_Cultured_Cells_Bivalent_Enhancer
Muscle_Satellite_Cultured_Cells_Active_TSS	Fetal_Intestine_Small_Weak_transcription
HUES64_Cell_Line_Enhancers	HSMMtube_Skeletal_Muscle_Myotubes_Derived_from_HSMM_Transcr_at_gene_5_and_3
Gastric_Active_TSS	Breast_vHMEC_Flanking_Active_TSS
Fetal_Stomach_ZNF_genes_and_repeats	iPS_DF_6.9_Cell_Line_Bivalent_Enhancer
H9_Derived_Neuron_Cultured_Cells_ZNF_genes_and_repeats	HeLa_S3_Cervical_Carcinoma_Weak_transcription
K562_Leukemia_ZNF_genes_and_repeats	HSMM_Skeletal_Muscle_Myoblasts_Heterochromatin
Muscle_Satellite_Cultured_Cells_Enhancers	Muscle_Satellite_Cultured_Cells_Transcr_at_gene_5_and_3
Penis_Foreskin_Fibroblast_Primary_Cells_skin01_Transcr_at_gene_5_and_3	Fetal_Brain_Female_Genic_enhancers
Rectal_Smooth_Muscle_ZNF_genes_and_repeats	Adult_Liver_Active_TSS
Muscle_Satellite_Cultured_Cells_ZNF_genes_and_repeats	Fetal_Brain_Female_Bivalent_Poised_TSS
Right_Atrium_Weak_Repressed_PolyComb	Adipose_Nuclei_Weak_transcription
Mesenchymal_Stem_Cell_Derived_Adipocyte_Cultured_Cells_Active_TSS	Rectal_Mucosa.Donor_31_Weak_transcription
Right_Atrium_Repressed_PolyComb	Gastric_Transcr_at_gene_5_and_3
Skeletal_Muscle_Female_Enhancers	Fetal_Stomach_Bivalent_Poised_TSS
iPS_18_Cell_Line_Enhancers	Penis_Foreskin_Melanocyte_Primary_Cells_skin01_ZNF_genes_and_repeats
Fetal_Thymus_Transcr_at_gene_5_and_3	CD4_Naive_Primary_Cells_Bivalent_Enhancer
Fetal_Thymus_Active_TSS	Chondrocytes_from_Bone_Marrow_Derived_Mesenchymal_Stem_Cell_Cultured_Cells_Bivalent_Poised_TSS
Osteoblasts_ZNF_genes_and_repeats	CD15_Primary_Cells_Genic_enhancers
CD4pp_CD25__IL17pp_PMA_Ionomcyin_stimulated_Th17_Primary_Cells_Enhancers	Brain_Substantia_Nigra_Transcr_at_gene_5_and_3
Osteoblasts_Enhancers	Fetal_Stomach_Active_TSS
IMR90_Cell_Line_Enhancers	Fetal_Stomach_Flanking_Bivalent_TSS_Enh
Skeletal_Muscle_Female_ZNF_genes_and_repeats	Stomach_Mucosa_Weak_transcription
Brain_Cingulate_Gyrus_Genic_enhancers	Fetal_Heart_Bivalent_Poised_TSS
CD4_Naive_Primary_Cells_Active_TSS	Monocytes_CD14pp_RO01746_Weak_transcription
Fetal_Lung_ZNF_genes_and_repeats	hESC_Derived_CD56pp_Mesoderm_Cultured_Cells_Flanking_Active_TSS
Monocytes_CD14pp_RO01746_Flanking_Active_TSS	Penis_Foreskin_Fibroblast_Primary_Cells_skin02_ZNF_genes_and_repeats
Spleen_Genic_enhancers	Brain_Angular_Gyrus_Weak_transcription
CD4_Memory_Primary_Cells_Active_TSS	Psoas_Muscle_Bivalent_Enhancer
Brain_Mid_Frontal_Lobe_ZNF_genes_and_repeats	Neurosphere_Cultured_Cells_Ganglionic_Eminence_Derived_Weak_transcription
HUES48_Cell_Line_Enhancers	CD34_Cultured_Cells_Heterochromatin
Mobilized_CD34_Primary_Cells_Male_Enhancers	Penis_Foreskin_Melanocyte_Primary_Cells_skin03_Weak_transcription
HeLa_S3_Cervical_Carcinoma_Enhancers	iPS_20b_Cell_Line_Flanking_Bivalent_TSS_Enh
NHLF_Lung_Fibroblasts_Enhancers	Pancreas_Repressed_PolyComb
GM12878_Lymphoblastoid_Transcr_at_gene_5_and_3	Pancreatic_Islets_Transcr_at_gene_5_and_3
Bone_Marrow_Derived_Mesenchymal_Stem_Cell_Cultured_Cells_Genic_enhancers	Fetal_Adrenal_Gland_Transcr_at_gene_5_and_3
CD8_Memory_Primary_Cells_ZNF_genes_and_repeats	Penis_Foreskin_Melanocyte_Primary_Cells_skin01_Genic_enhancers
Dnd41_TCell_Leukemia_Flanking_Active_TSS	iPS_DF_6.9_Cell_Line_Active_TSS
Adipose_Nuclei_Enhancers	Brain_Mid_Frontal_Lobe_Bivalent_Poised_TSS
H9_Derived_Neuron_Cultured_Cells_Active_TSS	CD34_Cultured_Cells_Bivalent_Poised_TSS
hESC_Derived_CD56pp_Ectoderm_Cultured_Cells_Enhancers	CD4pp_CD25__IL17__PMA_Ionomycin_stimulated_MACS_purified_Th_Primary_Cells_Active_TSS
iPS_15b_Cell_Line_Enhancers	Aorta_Bivalent_Enhancer
Skeletal_Muscle_Male_Enhancers	Duodenum_Mucosa_Transcr_at_gene_5_and_3
Monocytes_CD14pp_RO01746_Genic_enhancers	Thymus_Heterochromatin
Bone_Marrow_Derived_Mesenchymal_Stem_Cell_Cultured_Cells_Transcr_at_gene_5_and_3	Adult_Liver_Transcr_at_gene_5_and_3
Colon_Smooth_Muscle_Enhancers	Fetal_Intestine_Large_Weak_transcription
CD15_Primary_Cells_Transcr_at_gene_5_and_3	Brain_Hippocampus_Middle_Weak_transcription
Fetal_Thymus_ZNF_genes_and_repeats	CD4pp_CD25int_CD127pp_Tmem_Primary_Cells_Genic_enhancers
Bone_Marrow_Derived_Mesenchymal_Stem_Cell_Cultured_Cells_Enhancers	Rectal_Mucosa.Donor_29_Transcr_at_gene_5_and_3
K562_Leukemia_Enhancers	hESC_Derived_CD56pp_Ectoderm_Cultured_Cells_Bivalent_Poised_TSS
Brain_Inferior_Temporal_Lobe_ZNF_genes_and_repeats	Gastric_Bivalent_Poised_TSS
HUVEC_Umbilical_Vein_Endothelial_Cells_Transcr_at_gene_5_and_3	CD4_Naive_Primary_Cells_Active_TSS
HSMMtube_Skeletal_Muscle_Myotubes_Derived_from_HSMM_Enhancers	Monocytes_CD14pp_RO01746_Active_TSS
Thymus_Genic_enhancers	Fetal_Muscle_Leg_Flanking_Bivalent_TSS_Enh
Penis_Foreskin_Melanocyte_Primary_Cells_skin01_ZNF_genes_and_repeats	iPS_DF_6.9_Cell_Line_Flanking_Active_TSS
HMEC_Mammary_Epithelial_Weak_Repressed_PolyComb	H9_Derived_Neuron_Cultured_Cells_Heterochromatin
Stomach_Mucosa_ZNF_genes_and_repeats	Colonic_Mucosa_Transcr_at_gene_5_and_3
GM12878_Lymphoblastoid_Weak_Repressed_PolyComb	Adult_Liver_Bivalent_Enhancer
Fetal_Brain_Male_ZNF_genes_and_repeats	iPS_18_Cell_Line_Flanking_Active_TSS
Mesenchymal_Stem_Cell_Derived_Adipocyte_Cultured_Cells_Genic_enhancers	Monocytes_CD14pp_RO01746_Genic_enhancers
CD8_Naive_Primary_Cells_Active_TSS	Right_Ventricle_Bivalent_Poised_TSS
NH_A_Astrocytes_Active_TSS	HeLa_S3_Cervical_Carcinoma_Transcr_at_gene_5_and_3
K562_Leukemia_Weak_Repressed_PolyComb	CD34_Cultured_Cells_Genic_enhancers
Muscle_Satellite_Cultured_Cells_Transcr_at_gene_5_and_3	Bone_Marrow_Derived_Mesenchymal_Stem_Cell_Cultured_Cells_Bivalent_Poised_TSS
NHEK_Epidermal_Keratinocytes_ZNF_genes_and_repeats	IMR90_Cell_Line_Flanking_Bivalent_TSS_Enh
Psoas_Muscle_Repressed_PolyComb	Gastric_Flanking_Active_TSS
Ovary_Weak_Repressed_PolyComb	Fetal_Heart_Transcr_at_gene_5_and_3
CD4pp_CD25int_CD127pp_Tmem_Primary_Cells_Active_TSS	Right_Atrium_Bivalent_Poised_TSS
Pancreatic_Islets_Transcr_at_gene_5_and_3	Fetal_Intestine_Small_Bivalent_Poised_TSS
HUVEC_Umbilical_Vein_Endothelial_Cells_ZNF_genes_and_repeats	Chondrocytes_from_Bone_Marrow_Derived_Mesenchymal_Stem_Cell_Cultured_Cells_Flanking_Bivalent_TSS_Enh
HUES6_Cell_Line_Enhancers	HSMMtube_Skeletal_Muscle_Myotubes_Derived_from_HSMM_Heterochromatin
ES_I3_Cell_Line_ZNF_genes_and_repeats	H1_BMP4_Derived_Trophoblast_Cultured_Cells_Bivalent_Poised_TSS
CD4pp_CD25pp_CD127__Treg_Primary_Cells_Weak_Repressed_PolyComb	Colonic_Mucosa_Bivalent_Poised_TSS
Thymus_ZNF_genes_and_repeats	Penis_Foreskin_Keratinocyte_Primary_Cells_skin03_Flanking_Bivalent_TSS_Enh
H9_Cell_Line_Bivalent_Poised_TSS	HepG2_Hepatocellular_Carcinoma_Transcr_at_gene_5_and_3
HeLa_S3_Cervical_Carcinoma_Weak_Repressed_PolyComb	Fetal_Muscle_Trunk_Bivalent_Poised_TSS
HSMMtube_Skeletal_Muscle_Myotubes_Derived_from_HSMM_Genic_enhancers	Fetal_Thymus_Weak_transcription
Sigmoid_Colon_ZNF_genes_and_repeats	Mobilized_CD34_Primary_Cells_Female_Bivalent_Poised_TSS
Colon_Smooth_Muscle_ZNF_genes_and_repeats	Pancreas_Bivalent_Enhancer
Penis_Foreskin_Fibroblast_Primary_Cells_skin02_Genic_enhancers	Fetal_Placenta_Bivalent_Poised_TSS
Right_Atrium_Strong_transcription	CD14_Primary_Cells_Weak_transcription
CD56_Primary_Cells_Transcr_at_gene_5_and_3	CD19_Primary_Cells_Cord_BI_Genic_enhancers
Breast_vHMEC_ZNF_genes_and_repeats	Rectal_Mucosa.Donor_29_Flanking_Bivalent_TSS_Enh
Brain_Hippocampus_Middle_Enhancers	IMR90_Cell_Line_Bivalent_Poised_TSS
Colonic_Mucosa_Active_TSS	iPS_DF_19.11_Cell_Line_Active_TSS
NH_A_Astrocytes_Enhancers	Fetal_Stomach_Transcr_at_gene_5_and_3
Brain_Substantia_Nigra_Enhancers	A549_EtOH_0.02pct_Lung_Carcinoma_Bivalent_Poised_TSS
CD4_Memory_Primary_Cells_ZNF_genes_and_repeats	ES_WA7_Cell_Line_Bivalent_Poised_TSS
CD4pp_CD25__IL17__PMA_Ionomycin_stimulated_MACS_purified_Th_Primary_Cells_Active_TSS	CD56_Primary_Cells_Genic_enhancers
CD4pp_CD25int_CD127pp_Tmem_Primary_Cells_Transcr_at_gene_5_and_3	Gastric_Bivalent_Enhancer
NHEK_Epidermal_Keratinocytes_Transcr_at_gene_5_and_3	H1_BMP4_Derived_Trophoblast_Cultured_Cells_ZNF_genes_and_repeats
Brain_Anterior_Caudate_ZNF_genes_and_repeats	Ovary_Heterochromatin
Penis_Foreskin_Fibroblast_Primary_Cells_skin02_Transcr_at_gene_5_and_3	Dnd41_TCell_Leukemia_Flanking_Bivalent_TSS_Enh
CD4pp_CD25__Th_Primary_Cells_Weak_Repressed_PolyComb	Gastric_Flanking_Bivalent_TSS_Enh
CD14_Primary_Cells_Transcr_at_gene_5_and_3	CD3_Primary_Cells_Cord_BI_Bivalent_Poised_TSS
Placenta_Amnion_Enhancers	Fetal_Muscle_Leg_Genic_enhancers
H1_BMP4_Derived_Trophoblast_Cultured_Cells_Active_TSS	Fetal_Intestine_Large_Bivalent_Poised_TSS
Duodenum_Mucosa_Genic_enhancers	Brain_Substantia_Nigra_Weak_transcription
Breast_vHMEC_Genic_enhancers	Fetal_Muscle_Trunk_Active_TSS
HUES48_Cell_Line_Transcr_at_gene_5_and_3	CD56_Primary_Cells_Weak_transcription
HUES6_Cell_Line_Genic_enhancers	Muscle_Satellite_Cultured_Cells_Flanking_Bivalent_TSS_Enh
Rectal_Mucosa.Donor_29_Active_TSS	Fetal_Lung_Flanking_Bivalent_TSS_Enh
NH_A_Astrocytes_Genic_enhancers	Peripheral_Blood_Mononuclear_Primary_Cells_Genic_enhancers
CD4pp_CD25__IL17__PMA_Ionomycin_stimulated_MACS_purified_Th_Primary_Cells_Weak_Repressed_PolyComb	H9_Cell_Line_ZNF_genes_and_repeats
ES_I3_Cell_Line_Enhancers	CD15_Primary_Cells_Bivalent_Poised_TSS
HSMM_Skeletal_Muscle_Myoblasts_ZNF_genes_and_repeats	Fetal_Muscle_Leg_Bivalent_Poised_TSS
Penis_Foreskin_Fibroblast_Primary_Cells_skin02_ZNF_genes_and_repeats	Neurosphere_Cultured_Cells_Cortex_Derived_Genic_enhancers
Rectal_Mucosa.Donor_31_Active_TSS	Brain_Germinal_Matrix_Transcr_at_gene_5_and_3
Skeletal_Muscle_Male_Transcr_at_gene_5_and_3	Colonic_Mucosa_Genic_enhancers
Rectal_Mucosa.Donor_31_Genic_enhancers	A549_EtOH_0.02pct_Lung_Carcinoma_Transcr_at_gene_5_and_3
HeLa_S3_Cervical_Carcinoma_Genic_enhancers	Fetal_Muscle_Trunk_Genic_enhancers
iPS_20b_Cell_Line_Bivalent_Poised_TSS	CD4pp_CD25int_CD127pp_Tmem_Primary_Cells_Quiescent_Low
Penis_Foreskin_Fibroblast_Primary_Cells_skin01_Active_TSS	CD8_Memory_Primary_Cells_Active_TSS
Duodenum_Mucosa_Active_TSS	CD8_Memory_Primary_Cells_Quiescent_Low
CD4_Naive_Primary_Cells_ZNF_genes_and_repeats	Colonic_Mucosa_Quiescent_Low
Lung_Repressed_PolyComb	ES_WA7_Cell_Line_Flanking_Bivalent_TSS_Enh
Stomach_Smooth_Muscle_ZNF_genes_and_repeats	ES_WA7_Cell_Line_Quiescent_Low
Mobilized_CD34_Primary_Cells_Female_Flanking_Active_TSS	ES_WA7_Cell_Line_Transcr_at_gene_5_and_3
Penis_Foreskin_Melanocyte_Primary_Cells_skin01_Genic_enhancers	H1_BMP4_Derived_Mesendoderm_Cultured_Cells_Quiescent_Low
Osteoblasts_Active_TSS	Mesenchymal_Stem_Cell_Derived_Adipocyte_Cultured_Cells_Flanking_Bivalent_TSS_Enh
iPS_15b_Cell_Line_Bivalent_Poised_TSS	Placenta_Amnion_Quiescent_Low
H1_BMP4_Derived_Trophoblast_Cultured_Cells_Genic_enhancers	Rectal_Smooth_Muscle_Flanking_Bivalent_TSS_Enh
Neurosphere_Cultured_Cells_Ganglionic_Eminence_Derived_Enhancers	Stomach_Mucosa_Quiescent_Low
CD4pp_CD25pp_CD127__Treg_Primary_Cells_Enhancers	Thymus_Quiescent_Low
Mesenchymal_Stem_Cell_Derived_Adipocyte_Cultured_Cells_Enhancers	hESC_Derived_CD56pp_Ectoderm_Cultured_Cells_Quiescent_Low
Brain_Germinal_Matrix_Enhancers	iPS_15b_Cell_Line_Quiescent_Low
4star_Genic_enhancers	Thymus_Genic_enhancers
Fetal_Heart_Genic_enhancers	HUVEC_Umbilical_Vein_Endothelial_Cells_Transcr_at_gene_5_and_3
A549_EtOH_0.02pct_Lung_Carcinoma_Transcr_at_gene_5_and_3	CD19_Primary_Cells_Cord_BI_Active_TSS
Brain_Inferior_Temporal_Lobe_Genic_enhancers	NH_A_Astrocytes_Heterochromatin
Fetal_Heart_Active_TSS	Mobilized_CD34_Primary_Cells_Male_Active_TSS
HepG2_Hepatocellular_Carcinoma_Transcr_at_gene_5_and_3	Brain_Angular_Gyrus_Transcr_at_gene_5_and_3
Brain_Cingulate_Gyrus_ZNF_genes_and_repeats	Osteoblasts_Flanking_Bivalent_TSS_Enh
HUES6_Cell_Line_Transcr_at_gene_5_and_3	K562_Leukemia_Transcr_at_gene_5_and_3
Right_Ventricle_Genic_enhancers	CD4pp_CD25__CD45ROpp_Memory_Primary_Cells_Bivalent_Poised_TSS
iPS_DF_19.11_Cell_Line_Genic_enhancers	Mesenchymal_Stem_Cell_Derived_Adipocyte_Cultured_Cells_Bivalent_Poised_TSS
H1_Cell_Line_Enhancers	HepG2_Hepatocellular_Carcinoma_Weak_transcription
CD15_Primary_Cells_Flanking_Active_TSS	NHEK_Epidermal_Keratinocytes_Weak_transcription
iPS_18_Cell_Line_Genic_enhancers	Gastric_Genic_enhancers
NH_A_Astrocytes_Transcr_at_gene_5_and_3	CD34_Primary_Cells_Active_TSS
K562_Leukemia_Transcr_at_gene_5_and_3	CD4pp_CD25__CD45RApp_Naive_Primary_Cells_Active_TSS
H9_Derived_Neuronal_Progenitor_Cultured_Cells_Genic_enhancers	H1_Cell_Line_Bivalent_Poised_TSS
Placenta_Amnion_Genic_enhancers	Brain_Substantia_Nigra_Bivalent_Poised_TSS
CD19_Primary_Cells_Peripheral_UW_Transcr_at_gene_5_and_3	Mobilized_CD34_Primary_Cells_Female_Transcr_at_gene_5_and_3
iPS_20b_Cell_Line_Transcr_at_gene_5_and_3	Brain_Germinal_Matrix_Weak_transcription
HUES48_Cell_Line_Genic_enhancers	Adipose_Derived_Mesenchymal_Stem_Cell_Cultured_Cells_Weak_transcription
Rectal_Smooth_Muscle_Enhancers	Fetal_Lung_Transcr_at_gene_5_and_3
Brain_Cingulate_Gyrus_Enhancers	Right_Atrium_Flanking_Bivalent_TSS_Enh
Brain_Angular_Gyrus_ZNF_genes_and_repeats	A549_EtOH_0.02pct_Lung_Carcinoma_Flanking_Bivalent_TSS_Enh
Rectal_Mucosa.Donor_31_Enhancers	Neurosphere_Cultured_Cells_Cortex_Derived_Bivalent_Poised_TSS
Fetal_Placenta_Active_TSS	Spleen_Active_TSS
Monocytes_CD14pp_RO01746_Transcr_at_gene_5_and_3	Lung_ZNF_genes_and_repeats
Penis_Foreskin_Melanocyte_Primary_Cells_skin03_Active_TSS	HSMMtube_Skeletal_Muscle_Myotubes_Derived_from_HSMM_Flanking_Bivalent_TSS_Enh
Neurosphere_Cultured_Cells_Ganglionic_Eminence_Derived_Active_TSS	Pancreas_Flanking_Bivalent_TSS_Enh
H9_Derived_Neuron_Cultured_Cells_Genic_enhancers	NHEK_Epidermal_Keratinocytes_Bivalent_Poised_TSS
hESC_Derived_CD184pp_Endoderm_Cultured_Cells_Genic_enhancers	Penis_Foreskin_Keratinocyte_Primary_Cells_skin02_Flanking_Bivalent_TSS_Enh
Brain_Anterior_Caudate_Genic_enhancers	Neurosphere_Cultured_Cells_Ganglionic_Eminence_Derived_Bivalent_Poised_TSS
hESC_Derived_CD184pp_Endoderm_Cultured_Cells_Enhancers	CD19_Primary_Cells_Peripheral_UW_Genic_enhancers
hESC_Derived_CD184pp_Endoderm_Cultured_Cells_Transcr_at_gene_5_and_3	CD4_Memory_Primary_Cells_Bivalent_Enhancer
HUES48_Cell_Line_Bivalent_Poised_TSS	Penis_Foreskin_Keratinocyte_Primary_Cells_skin02_Genic_enhancers
Brain_Substantia_Nigra_ZNF_genes_and_repeats	CD4pp_CD25int_CD127pp_Tmem_Primary_Cells_Bivalent_Enhancer
HUES64_Cell_Line_Genic_enhancers	NHEK_Epidermal_Keratinocytes_Flanking_Bivalent_TSS_Enh
4star_Enhancers	Peripheral_Blood_Mononuclear_Primary_Cells_Weak_transcription
Brain_Angular_Gyrus_Enhancers	Pancreatic_Islets_Bivalent_Poised_TSS
Dnd41_TCell_Leukemia_Active_TSS	CD4pp_CD25pp_CD127__Treg_Primary_Cells_Transcr_at_gene_5_and_3
Brain_Germinal_Matrix_Genic_enhancers	Pancreas_Active_TSS
CD3_Primary_Cells_Cord_BI_Active_TSS	H1_Derived_Mesenchymal_Stem_Cells_Transcr_at_gene_5_and_3
Brain_Hippocampus_Middle_ZNF_genes_and_repeats	Rectal_Smooth_Muscle_Transcr_at_gene_5_and_3
Ovary_Enhancers	HepG2_Hepatocellular_Carcinoma_Bivalent_Poised_TSS
HMEC_Mammary_Epithelial_Transcr_at_gene_5_and_3	Fetal_Muscle_Leg_Active_TSS
H1_Derived_Mesenchymal_Stem_Cells_Genic_enhancers	H9_Cell_Line_Flanking_Active_TSS
Rectal_Smooth_Muscle_Genic_enhancers	Bone_Marrow_Derived_Mesenchymal_Stem_Cell_Cultured_Cells_Weak_transcription
Right_Ventricle_ZNF_genes_and_repeats	Left_Ventricle_Weak_transcription
H1_Cell_Line_Transcr_at_gene_5_and_3	Stomach_Smooth_Muscle_Genic_enhancers
CD4pp_CD25__CD45ROpp_Memory_Primary_Cells_Active_TSS	H1_Derived_Mesenchymal_Stem_Cells_Genic_enhancers
Penis_Foreskin_Fibroblast_Primary_Cells_skin02_Active_TSS	H9_Derived_Neuron_Cultured_Cells_Weak_transcription
Left_Ventricle_Enhancers	GM12878_Lymphoblastoid_Weak_transcription
Penis_Foreskin_Keratinocyte_Primary_Cells_skin03_Active_TSS	Lung_Bivalent_Poised_TSS
Skeletal_Muscle_Male_Active_TSS	Brain_Angular_Gyrus_Bivalent_Poised_TSS
iPS_DF_19.11_Cell_Line_Active_TSS	Penis_Foreskin_Fibroblast_Primary_Cells_skin02_Weak_transcription
Mesenchymal_Stem_Cell_Derived_Adipocyte_Cultured_Cells_Transcr_at_gene_5_and_3	Placenta_Amnion_Genic_enhancers
CD4_Naive_Primary_Cells_Transcr_at_gene_5_and_3	GM12878_Lymphoblastoid_Transcr_at_gene_5_and_3
Thymus_Enhancers	Fetal_Placenta_Active_TSS
Monocytes_CD14pp_RO01746_Enhancers	CD34_Primary_Cells_Bivalent_Poised_TSS
Fetal_Lung_Genic_enhancers	Neurosphere_Cultured_Cells_Ganglionic_Eminence_Derived_Genic_enhancers
HeLa_S3_Cervical_Carcinoma_Transcr_at_gene_5_and_3	Rectal_Mucosa.Donor_31_Flanking_Bivalent_TSS_Enh
NH_A_Astrocytes_ZNF_genes_and_repeats	Lung_Flanking_Active_TSS
Neurosphere_Cultured_Cells_Ganglionic_Eminence_Derived_Genic_enhancers	H1_BMP4_Derived_Trophoblast_Cultured_Cells_Transcr_at_gene_5_and_3
CD4pp_CD25__Th_Primary_Cells_Transcr_at_gene_5_and_3	Fetal_Kidney_Transcr_at_gene_5_and_3
Duodenum_Mucosa_Enhancers	HUVEC_Umbilical_Vein_Endothelial_Cells_Bivalent_Poised_TSS
GM12878_Lymphoblastoid_Enhancers	Right_Ventricle_Genic_enhancers
Brain_Angular_Gyrus_Genic_enhancers	Esophagus_Heterochromatin
Neurosphere_Cultured_Cells_Cortex_Derived_Active_TSS	Rectal_Mucosa.Donor_31_Bivalent_Poised_TSS
HUVEC_Umbilical_Vein_Endothelial_Cells_Active_TSS	CD4pp_CD25__Th_Primary_Cells_Weak_transcription
Adipose_Derived_Mesenchymal_Stem_Cell_Cultured_Cells_Transcr_at_gene_5_and_3	HeLa_S3_Cervical_Carcinoma_Heterochromatin
Adult_Liver_Active_TSS	Brain_Inferior_Temporal_Lobe_Flanking_Bivalent_TSS_Enh
Brain_Anterior_Caudate_Enhancers	Pancreatic_Islets_Flanking_Bivalent_TSS_Enh
H1_Derived_Mesenchymal_Stem_Cells_Active_TSS	NH_A_Astrocytes_Transcr_at_gene_5_and_3
Brain_Substantia_Nigra_Genic_enhancers	Spleen_Bivalent_Enhancer
Brain_Germinal_Matrix_Active_TSS	Stomach_Mucosa_Flanking_Bivalent_TSS_Enh
Fetal_Intestine_Small_Transcr_at_gene_5_and_3	Penis_Foreskin_Fibroblast_Primary_Cells_skin01_Genic_enhancers
CD3_Primary_Cells_Peripheral_UW_Transcr_at_gene_5_and_3	Skeletal_Muscle_Female_Weak_transcription
Osteoblasts_Transcr_at_gene_5_and_3	CD4pp_CD25pp_CD127__Treg_Primary_Cells_Bivalent_Poised_TSS
Peripheral_Blood_Mononuclear_Primary_Cells_Genic_enhancers	Neurosphere_Cultured_Cells_Cortex_Derived_Weak_transcription
CD19_Primary_Cells_Cord_BI_Flanking_Active_TSS	Neurosphere_Cultured_Cells_Ganglionic_Eminence_Derived_Transcr_at_gene_5_and_3
CD4_Memory_Primary_Cells_Transcr_at_gene_5_and_3	Colon_Smooth_Muscle_Bivalent_Poised_TSS
A549_EtOH_0.02pct_Lung_Carcinoma_Enhancers	HUES48_Cell_Line_Flanking_Active_TSS
Fetal_Muscle_Trunk_Enhancers	Left_Ventricle_Bivalent_Poised_TSS
Duodenum_Smooth_Muscle_Genic_enhancers	Breast_vHMEC_Active_TSS
CD34_Primary_Cells_Genic_enhancers	Bone_Marrow_Derived_Mesenchymal_Stem_Cell_Cultured_Cells_Flanking_Bivalent_TSS_Enh
HepG2_Hepatocellular_Carcinoma_Bivalent_Poised_TSS	Esophagus_Genic_enhancers
Lung_Genic_enhancers	HUES64_Cell_Line_Flanking_Bivalent_TSS_Enh
Ovary_ZNF_genes_and_repeats	Brain_Anterior_Caudate_Flanking_Bivalent_TSS_Enh
CD14_Primary_Cells_Active_TSS	CD34_Cultured_Cells_Active_TSS
Penis_Foreskin_Keratinocyte_Primary_Cells_skin03_Transcr_at_gene_5_and_3	Fetal_Intestine_Large_Genic_enhancers
iPS_20b_Cell_Line_Enhancers	HSMMtube_Skeletal_Muscle_Myotubes_Derived_from_HSMM_Weak_transcription
Sigmoid_Colon_Weak_Repressed_PolyComb	CD8_Naive_Primary_Cells_Active_TSS
Brain_Inferior_Temporal_Lobe_Enhancers	Brain_Hippocampus_Middle_Flanking_Bivalent_TSS_Enh
CD19_Primary_Cells_Peripheral_UW_Active_TSS	HUES64_Cell_Line_Flanking_Active_TSS
Rectal_Mucosa.Donor_29_Genic_enhancers	hESC_Derived_CD56pp_Mesoderm_Cultured_Cells_Bivalent_Enhancer
Chondrocytes_from_Bone_Marrow_Derived_Mesenchymal_Stem_Cell_Cultured_Cells_Transcr_at_gene_5_and_3	Dnd41_TCell_Leukemia_Transcr_at_gene_5_and_3
HUES6_Cell_Line_Bivalent_Poised_TSS	Stomach_Smooth_Muscle_Weak_transcription
CD4pp_CD25int_CD127pp_Tmem_Primary_Cells_Enhancers	Brain_Mid_Frontal_Lobe_Flanking_Bivalent_TSS_Enh
Fetal_Brain_Male_Active_TSS	H1_Derived_Neuronal_Progenitor_Cultured_Cells_Heterochromatin
Penis_Foreskin_Fibroblast_Primary_Cells_skin02_Enhancers	CD4pp_CD25__IL17pp_PMA_Ionomcyin_stimulated_Th17_Primary_Cells_Active_TSS
iPS_18_Cell_Line_Bivalent_Poised_TSS	Neurosphere_Cultured_Cells_Cortex_Derived_Transcr_at_gene_5_and_3
Brain_Mid_Frontal_Lobe_Genic_enhancers	Sigmoid_Colon_Transcr_at_gene_5_and_3
CD4pp_CD25__Th_Primary_Cells_Flanking_Active_TSS	ES_WA7_Cell_Line_Genic_enhancers
Right_Ventricle_Enhancers	NHDF_Ad_Adult_Dermal_Fibroblasts_Flanking_Bivalent_TSS_Enh
Duodenum_Smooth_Muscle_Enhancers	H9_Derived_Neuronal_Progenitor_Cultured_Cells_Heterochromatin
CD19_Primary_Cells_Cord_BI_Transcr_at_gene_5_and_3	iPS_DF_19.11_Cell_Line_Heterochromatin
Colonic_Mucosa_Genic_enhancers	GM12878_Lymphoblastoid_Flanking_Bivalent_TSS_Enh
CD3_Primary_Cells_Peripheral_UW_Active_TSS	Mesenchymal_Stem_Cell_Derived_Adipocyte_Cultured_Cells_Weak_transcription
Stomach_Smooth_Muscle_Transcr_at_gene_5_and_3	H1_BMP4_Derived_Mesendoderm_Cultured_Cells_Genic_enhancers
Spleen_Active_TSS	Muscle_Satellite_Cultured_Cells_Bivalent_Poised_TSS
Psoas_Muscle_ZNF_genes_and_repeats	Gastric_Heterochromatin
H9_Derived_Neuron_Cultured_Cells_Transcr_at_gene_5_and_3	Dnd41_TCell_Leukemia_Genic_enhancers
Penis_Foreskin_Keratinocyte_Primary_Cells_skin02_Active_TSS	CD4_Memory_Primary_Cells_Active_TSS
HUES64_Cell_Line_Transcr_at_gene_5_and_3	K562_Leukemia_Heterochromatin
NHLF_Lung_Fibroblasts_ZNF_genes_and_repeats	Brain_Cingulate_Gyrus_Flanking_Bivalent_TSS_Enh
Penis_Foreskin_Keratinocyte_Primary_Cells_skin02_Transcr_at_gene_5_and_3	Mobilized_CD34_Primary_Cells_Male_Genic_enhancers
H9_Derived_Neuronal_Progenitor_Cultured_Cells_Transcr_at_gene_5_and_3	Psoas_Muscle_Transcr_at_gene_5_and_3
IMR90_Cell_Line_Quiescent_Low	Fetal_Heart_Flanking_Bivalent_TSS_Enh
Penis_Foreskin_Melanocyte_Primary_Cells_skin01_Enhancers	Fetal_Intestine_Small_Flanking_Bivalent_TSS_Enh
CD56_Primary_Cells_Active_TSS	NHDF_Ad_Adult_Dermal_Fibroblasts_Bivalent_Poised_TSS
Esophagus_Genic_enhancers	Lung_Flanking_Bivalent_TSS_Enh
Adult_Liver_Transcr_at_gene_5_and_3	H1_BMP4_Derived_Trophoblast_Cultured_Cells_Flanking_Active_TSS
H1_BMP4_Derived_Trophoblast_Cultured_Cells_Enhancers	CD19_Primary_Cells_Peripheral_UW_Weak_transcription
Chondrocytes_from_Bone_Marrow_Derived_Mesenchymal_Stem_Cell_Cultured_Cells_Active_TSS	Mobilized_CD34_Primary_Cells_Female_Flanking_Bivalent_TSS_Enh
H1_Cell_Line_Genic_enhancers	CD4pp_CD25pp_CD127__Treg_Primary_Cells_Flanking_Bivalent_TSS_Enh
Spleen_Enhancers	CD34_Primary_Cells_Transcr_at_gene_5_and_3
Brain_Mid_Frontal_Lobe_Enhancers	Fetal_Thymus_Genic_enhancers
Pancreatic_Islets_Weak_Repressed_PolyComb	IMR90_Cell_Line_Weak_transcription
Penis_Foreskin_Melanocyte_Primary_Cells_skin03_Transcr_at_gene_5_and_3	NHLF_Lung_Fibroblasts_Genic_enhancers
CD4pp_CD25__CD45RApp_Naive_Primary_Cells_Transcr_at_gene_5_and_3	Fetal_Placenta_Flanking_Bivalent_TSS_Enh
Fetal_Brain_Female_Enhancers	Gastric_ZNF_genes_and_repeats
iPS_18_Cell_Line_Transcr_at_gene_5_and_3	Penis_Foreskin_Keratinocyte_Primary_Cells_skin03_Bivalent_Poised_TSS
NHDF_Ad_Adult_Dermal_Fibroblasts_Transcr_at_gene_5_and_3	H9_Derived_Neuronal_Progenitor_Cultured_Cells_Genic_enhancers
CD34_Primary_Cells_Flanking_Active_TSS	Osteoblasts_Weak_transcription
hESC_Derived_CD184pp_Endoderm_Cultured_Cells_Bivalent_Poised_TSS	HSMM_Skeletal_Muscle_Myoblasts_Flanking_Bivalent_TSS_Enh
Pancreas_Genic_enhancers	Lung_Genic_enhancers
NHLF_Lung_Fibroblasts_Transcr_at_gene_5_and_3	Pancreas_ZNF_genes_and_repeats
Left_Ventricle_ZNF_genes_and_repeats	Neurosphere_Cultured_Cells_Cortex_Derived_Active_TSS
ES_I3_Cell_Line_Genic_enhancers	Right_Atrium_Heterochromatin
Psoas_Muscle_Enhancers	CD8_Memory_Primary_Cells_Bivalent_Poised_TSS
hESC_Derived_CD56pp_Ectoderm_Cultured_Cells_ZNF_genes_and_repeats	Duodenum_Smooth_Muscle_Transcr_at_gene_5_and_3
H1_Derived_Mesenchymal_Stem_Cells_ZNF_genes_and_repeats	Penis_Foreskin_Fibroblast_Primary_Cells_skin01_ZNF_genes_and_repeats
Stomach_Smooth_Muscle_Active_TSS	Sigmoid_Colon_Flanking_Active_TSS
CD3_Primary_Cells_Cord_BI_Transcr_at_gene_5_and_3	A549_EtOH_0.02pct_Lung_Carcinoma_Heterochromatin
CD4pp_CD25__CD45ROpp_Memory_Primary_Cells_Transcr_at_gene_5_and_3	Lung_Active_TSS
Right_Atrium_Enhancers	Pancreas_Heterochromatin
Pancreas_Enhancers	Brain_Germinal_Matrix_Flanking_Bivalent_TSS_Enh
Peripheral_Blood_Mononuclear_Primary_Cells_Transcr_at_gene_5_and_3	CD4pp_CD25__IL17pp_PMA_Ionomcyin_stimulated_Th17_Primary_Cells_Genic_enhancers
Sigmoid_Colon_Genic_enhancers	CD4pp_CD25__Th_Primary_Cells_Active_TSS
HSMMtube_Skeletal_Muscle_Myotubes_Derived_from_HSMM_ZNF_genes_and_repeats	Colon_Smooth_Muscle_Flanking_Bivalent_TSS_Enh
iPS_20b_Cell_Line_Genic_enhancers	hESC_Derived_CD56pp_Mesoderm_Cultured_Cells_Heterochromatin
Monocytes_CD14pp_RO01746_Active_TSS	Ovary_Bivalent_Poised_TSS
Brain_Germinal_Matrix_Transcr_at_gene_5_and_3	Penis_Foreskin_Melanocyte_Primary_Cells_skin01_Heterochromatin
Fetal_Brain_Female_Transcr_at_gene_5_and_3	Fetal_Adrenal_Gland_Active_TSS
Fetal_Brain_Female_Genic_enhancers	H9_Cell_Line_Heterochromatin
Left_Ventricle_Genic_enhancers	Fetal_Placenta_Genic_enhancers
Left_Ventricle_Transcr_at_gene_5_and_3	Thymus_Bivalent_Poised_TSS
Spleen_ZNF_genes_and_repeats	CD4pp_CD25__IL17__PMA_Ionomycin_stimulated_MACS_purified_Th_Primary_Cells_Weak_transcription
CD34_Cultured_Cells_Flanking_Active_TSS	Aorta_Genic_enhancers
Skeletal_Muscle_Female_Active_TSS	CD4pp_CD25__IL17__PMA_Ionomycin_stimulated_MACS_purified_Th_Primary_Cells_Bivalent_Poised_TSS
Chondrocytes_from_Bone_Marrow_Derived_Mesenchymal_Stem_Cell_Cultured_Cells_Flanking_Active_TSS	CD56_Primary_Cells_Bivalent_Poised_TSS
CD34_Cultured_Cells_Transcr_at_gene_5_and_3	Fetal_Brain_Female_Flanking_Bivalent_TSS_Enh
H9_Derived_Neuron_Cultured_Cells_Flanking_Active_TSS	Fetal_Brain_Male_Flanking_Bivalent_TSS_Enh
CD4pp_CD25pp_CD127__Treg_Primary_Cells_Transcr_at_gene_5_and_3	CD34_Primary_Cells_Weak_transcription
H1_Derived_Mesenchymal_Stem_Cells_Enhancers	CD4pp_CD25__IL17pp_PMA_Ionomcyin_stimulated_Th17_Primary_Cells_Flanking_Bivalent_TSS_Enh
Stomach_Smooth_Muscle_Enhancers	CD34_Primary_Cells_Genic_enhancers
Fetal_Heart_ZNF_genes_and_repeats	Sigmoid_Colon_Weak_transcription
iPS_15b_Cell_Line_Transcr_at_gene_5_and_3	GM12878_Lymphoblastoid_Bivalent_Poised_TSS
IMR90_Cell_Line_Transcr_at_gene_5_and_3	Psoas_Muscle_Bivalent_Poised_TSS
Gastric_Genic_enhancers	Brain_Mid_Frontal_Lobe_Genic_enhancers
Adipose_Nuclei_Flanking_Active_TSS	CD4pp_CD25__CD45RApp_Naive_Primary_Cells_Weak_transcription
Sigmoid_Colon_Enhancers	Esophagus_ZNF_genes_and_repeats
CD4pp_CD25__IL17__PMA_Ionomycin_stimulated_MACS_purified_Th_Primary_Cells_Flanking_Active_TSS	Skeletal_Muscle_Male_Genic_enhancers
Peripheral_Blood_Mononuclear_Primary_Cells_Flanking_Active_TSS	Brain_Germinal_Matrix_Bivalent_Poised_TSS
Adult_Liver_Weak_Repressed_PolyComb	CD4pp_CD25__Th_Primary_Cells_Bivalent_Poised_TSS
Duodenum_Smooth_Muscle_Transcr_at_gene_5_and_3	Fetal_Brain_Male_Weak_transcription
Skeletal_Muscle_Female_Transcr_at_gene_5_and_3	CD4pp_CD25__IL17pp_PMA_Ionomcyin_stimulated_Th17_Primary_Cells_Weak_transcription
H9_Cell_Line_ZNF_genes_and_repeats	CD8_Memory_Primary_Cells_Flanking_Bivalent_TSS_Enh
iPS_15b_Cell_Line_Genic_enhancers	Fetal_Brain_Male_Transcr_at_gene_5_and_3
Aorta_Repressed_PolyComb	Penis_Foreskin_Melanocyte_Primary_Cells_skin03_Flanking_Bivalent_TSS_Enh
hESC_Derived_CD56pp_Mesoderm_Cultured_Cells_Bivalent_Poised_TSS	HSMM_Skeletal_Muscle_Myoblasts_Weak_transcription
Penis_Foreskin_Melanocyte_Primary_Cells_skin01_Transcr_at_gene_5_and_3	Duodenum_Smooth_Muscle_Flanking_Bivalent_TSS_Enh
Fetal_Adrenal_Gland_Transcr_at_gene_5_and_3	Mobilized_CD34_Primary_Cells_Female_Genic_enhancers
Mobilized_CD34_Primary_Cells_Male_Transcr_at_gene_5_and_3	Pancreas_Genic_enhancers
hESC_Derived_CD56pp_Ectoderm_Cultured_Cells_Bivalent_Poised_TSS	Sigmoid_Colon_Bivalent_Poised_TSS
CD34_Cultured_Cells_Active_TSS	NHLF_Lung_Fibroblasts_Weak_transcription
HUVEC_Umbilical_Vein_Endothelial_Cells_Flanking_Active_TSS	H9_Cell_Line_Weak_transcription
Thymus_Transcr_at_gene_5_and_3	Rectal_Mucosa.Donor_29_Genic_enhancers
CD8_Memory_Primary_Cells_Transcr_at_gene_5_and_3	hESC_Derived_CD184pp_Endoderm_Cultured_Cells_Transcr_at_gene_5_and_3
Small_Intestine_Enhancers	Neurosphere_Cultured_Cells_Cortex_Derived_Flanking_Bivalent_TSS_Enh
HepG2_Hepatocellular_Carcinoma_Active_TSS	hESC_Derived_CD56pp_Mesoderm_Cultured_Cells_Transcr_at_gene_5_and_3
Rectal_Mucosa.Donor_29_Transcr_at_gene_5_and_3	Fetal_Lung_Genic_enhancers
Pancreatic_Islets_Bivalent_Poised_TSS	H1_BMP4_Derived_Mesendoderm_Cultured_Cells_Transcr_at_gene_5_and_3
Fetal_Kidney_Enhancers	CD4pp_CD25pp_CD127__Treg_Primary_Cells_Genic_enhancers
Neurosphere_Cultured_Cells_Ganglionic_Eminence_Derived_Transcr_at_gene_5_and_3	hESC_Derived_CD56pp_Ectoderm_Cultured_Cells_Flanking_Active_TSS
Brain_Hippocampus_Middle_Transcr_at_gene_5_and_3	Small_Intestine_Transcr_at_gene_5_and_3
Colon_Smooth_Muscle_Transcr_at_gene_5_and_3	CD8_Memory_Primary_Cells_Genic_enhancers
Placenta_Amnion_ZNF_genes_and_repeats	Aorta_Flanking_Bivalent_TSS_Enh
iPS_DF_6.9_Cell_Line_Bivalent_Poised_TSS	CD15_Primary_Cells_Weak_transcription
CD4pp_CD25pp_CD127__Treg_Primary_Cells_Flanking_Active_TSS	CD19_Primary_Cells_Cord_BI_Heterochromatin
Breast_vHMEC_Transcr_at_gene_5_and_3	Gastric_Active_TSS
Rectal_Mucosa.Donor_29_Enhancers	Fetal_Thymus_Active_TSS
hESC_Derived_CD56pp_Mesoderm_Cultured_Cells_Transcr_at_gene_5_and_3	CD4_Naive_Primary_Cells_Genic_enhancers
Pancreatic_Islets_Enhancers	Dnd41_TCell_Leukemia_Bivalent_Poised_TSS
Lung_Enhancers	Fetal_Placenta_ZNF_genes_and_repeats
Duodenum_Mucosa_Transcr_at_gene_5_and_3	CD3_Primary_Cells_Peripheral_UW_Genic_enhancers
H1_Cell_Line_Bivalent_Poised_TSS	Fetal_Intestine_Large_Flanking_Bivalent_TSS_Enh
Esophagus_Transcr_at_gene_5_and_3	H9_Derived_Neuron_Cultured_Cells_Bivalent_Poised_TSS
Stomach_Mucosa_Transcr_at_gene_5_and_3	CD19_Primary_Cells_Cord_BI_Flanking_Bivalent_TSS_Enh
CD19_Primary_Cells_Peripheral_UW_Bivalent_Enhancer	NHEK_Epidermal_Keratinocytes_Genic_enhancers
HSMM_Skeletal_Muscle_Myoblasts_Transcr_at_gene_5_and_3	4star_Bivalent_Poised_TSS
Mobilized_CD34_Primary_Cells_Female_Transcr_at_gene_5_and_3	CD8_Naive_Primary_Cells_Bivalent_Poised_TSS
Fetal_Kidney_ZNF_genes_and_repeats	Stomach_Mucosa_Active_TSS
H1_BMP4_Derived_Mesendoderm_Cultured_Cells_Enhancers	Skeletal_Muscle_Male_Weak_transcription
H9_Cell_Line_Enhancers	CD14_Primary_Cells_Bivalent_Poised_TSS
HeLa_S3_Cervical_Carcinoma_Flanking_Active_TSS	CD3_Primary_Cells_Peripheral_UW_Active_TSS
Fetal_Placenta_Transcr_at_gene_5_and_3	Small_Intestine_Flanking_Active_TSS
Esophagus_Enhancers	Fetal_Kidney_Heterochromatin
Psoas_Muscle_Transcr_at_gene_5_and_3	CD3_Primary_Cells_Peripheral_UW_Bivalent_Poised_TSS
Fetal_Muscle_Trunk_Bivalent_Enhancer	CD4_Naive_Primary_Cells_Flanking_Bivalent_TSS_Enh
H1_BMP4_Derived_Mesendoderm_Cultured_Cells_Bivalent_Poised_TSS	H1_BMP4_Derived_Trophoblast_Cultured_Cells_Genic_enhancers
Mobilized_CD34_Primary_Cells_Male_Flanking_Bivalent_TSS_Enh	Spleen_Flanking_Bivalent_TSS_Enh
Rectal_Mucosa.Donor_31_Transcr_at_gene_5_and_3	CD3_Primary_Cells_Cord_BI_Genic_enhancers
ES_WA7_Cell_Line_Enhancers	H9_Derived_Neuronal_Progenitor_Cultured_Cells_Bivalent_Poised_TSS
CD3_Primary_Cells_Cord_BI_Flanking_Active_TSS	Sigmoid_Colon_Flanking_Bivalent_TSS_Enh
Colonic_Mucosa_Enhancers	Neurosphere_Cultured_Cells_Ganglionic_Eminence_Derived_Flanking_Bivalent_TSS_Enh
Adipose_Nuclei_Active_TSS	Breast_Myoepithelial_Cells_Genic_enhancers
Fetal_Muscle_Leg_Transcr_at_gene_5_and_3	Esophagus_Flanking_Bivalent_TSS_Enh
hESC_Derived_CD56pp_Ectoderm_Cultured_Cells_Transcr_at_gene_5_and_3	Small_Intestine_Bivalent_Poised_TSS
Brain_Cingulate_Gyrus_Bivalent_Poised_TSS	Fetal_Adrenal_Gland_Weak_transcription
GM12878_Lymphoblastoid_Flanking_Active_TSS	Stomach_Mucosa_Genic_enhancers
H1_Derived_Neuronal_Progenitor_Cultured_Cells_Enhancers	H9_Derived_Neuron_Cultured_Cells_Genic_enhancers
Fetal_Intestine_Small_Bivalent_Poised_TSS	CD4pp_CD25int_CD127pp_Tmem_Primary_Cells_Bivalent_Poised_TSS
iPS_DF_19.11_Cell_Line_Enhancers	Small_Intestine_Flanking_Bivalent_TSS_Enh
CD3_Primary_Cells_Peripheral_UW_Flanking_Active_TSS	Ovary_Weak_transcription
Duodenum_Smooth_Muscle_Bivalent_Poised_TSS	HMEC_Mammary_Epithelial_Bivalent_Poised_TSS
ES_I3_Cell_Line_Transcr_at_gene_5_and_3	Brain_Cingulate_Gyrus_Genic_enhancers
HeLa_S3_Cervical_Carcinoma_ZNF_genes_and_repeats	Rectal_Mucosa.Donor_31_Genic_enhancers
HepG2_Hepatocellular_Carcinoma_Flanking_Active_TSS	HeLa_S3_Cervical_Carcinoma_ZNF_genes_and_repeats
Brain_Anterior_Caudate_Transcr_at_gene_5_and_3	hESC_Derived_CD184pp_Endoderm_Cultured_Cells_Weak_transcription
4star_Transcr_at_gene_5_and_3	Fetal_Thymus_ZNF_genes_and_repeats
Fetal_Intestine_Large_Transcr_at_gene_5_and_3	CD19_Primary_Cells_Peripheral_UW_Bivalent_Poised_TSS
Brain_Angular_Gyrus_Bivalent_Poised_TSS	Placenta_Amnion_ZNF_genes_and_repeats
A549_EtOH_0.02pct_Lung_Carcinoma_Bivalent_Poised_TSS	HeLa_S3_Cervical_Carcinoma_Genic_enhancers
Fetal_Intestine_Large_Bivalent_Poised_TSS	Pancreatic_Islets_Genic_enhancers
CD4pp_CD25__Th_Primary_Cells_Active_TSS	HMEC_Mammary_Epithelial_Genic_enhancers
Neurosphere_Cultured_Cells_Cortex_Derived_Flanking_Active_TSS	Colon_Smooth_Muscle_Genic_enhancers
Pancreas_Repressed_PolyComb	Sigmoid_Colon_Active_TSS
iPS_DF_19.11_Cell_Line_ZNF_genes_and_repeats	Penis_Foreskin_Keratinocyte_Primary_Cells_skin03_Genic_enhancers
hESC_Derived_CD56pp_Ectoderm_Cultured_Cells_Genic_enhancers	Right_Ventricle_Flanking_Bivalent_TSS_Enh
Rectal_Smooth_Muscle_Transcr_at_gene_5_and_3	Skeletal_Muscle_Male_ZNF_genes_and_repeats
Fetal_Brain_Male_Bivalent_Enhancer	CD14_Primary_Cells_Flanking_Bivalent_TSS_Enh
Right_Ventricle_Transcr_at_gene_5_and_3	CD8_Naive_Primary_Cells_Genic_enhancers
Spleen_Repressed_PolyComb	HUVEC_Umbilical_Vein_Endothelial_Cells_Flanking_Bivalent_TSS_Enh
Spleen_Bivalent_Enhancer	4star_Active_TSS
Mobilized_CD34_Primary_Cells_Female_Flanking_Bivalent_TSS_Enh	Colon_Smooth_Muscle_Weak_transcription
Lung_ZNF_genes_and_repeats	Placenta_Amnion_Bivalent_Poised_TSS
Brain_Cingulate_Gyrus_Transcr_at_gene_5_and_3	NHLF_Lung_Fibroblasts_Bivalent_Poised_TSS
Fetal_Brain_Female_Bivalent_Poised_TSS	Brain_Inferior_Temporal_Lobe_Genic_enhancers
Fetal_Lung_Transcr_at_gene_5_and_3	Fetal_Muscle_Leg_Weak_transcription
CD4pp_CD25pp_CD127__Treg_Primary_Cells_Active_TSS	CD15_Primary_Cells_Active_TSS
Dnd41_TCell_Leukemia_Flanking_Bivalent_TSS_Enh	CD3_Primary_Cells_Cord_BI_Flanking_Bivalent_TSS_Enh
Fetal_Muscle_Leg_Bivalent_Enhancer	Fetal_Muscle_Trunk_Weak_transcription
Adult_Liver_Flanking_Active_TSS	H1_Derived_Neuronal_Progenitor_Cultured_Cells_Transcr_at_gene_5_and_3
Fetal_Placenta_Bivalent_Enhancer	Duodenum_Smooth_Muscle_Weak_transcription
CD56_Primary_Cells_Bivalent_Enhancer	HSMMtube_Skeletal_Muscle_Myotubes_Derived_from_HSMM_Bivalent_Poised_TSS
Fetal_Muscle_Trunk_Transcr_at_gene_5_and_3	IMR90_Cell_Line_Genic_enhancers
Adipose_Nuclei_Transcr_at_gene_5_and_3	NHLF_Lung_Fibroblasts_Flanking_Bivalent_TSS_Enh
CD4pp_CD25__CD45RApp_Naive_Primary_Cells_Active_TSS	CD56_Primary_Cells_Flanking_Bivalent_TSS_Enh
Penis_Foreskin_Fibroblast_Primary_Cells_skin01_Quiescent_Low	K562_Leukemia_ZNF_genes_and_repeats
Stomach_Smooth_Muscle_Flanking_Active_TSS	CD15_Primary_Cells_Flanking_Bivalent_TSS_Enh
CD15_Primary_Cells_Active_TSS	CD4pp_CD25__IL17pp_PMA_Ionomcyin_stimulated_Th17_Primary_Cells_Bivalent_Poised_TSS
Gastric_ZNF_genes_and_repeats	HUVEC_Umbilical_Vein_Endothelial_Cells_Active_TSS
Skeletal_Muscle_Male_Flanking_Active_TSS	Breast_vHMEC_Bivalent_Poised_TSS
Adipose_Derived_Mesenchymal_Stem_Cell_Cultured_Cells_Bivalent_Poised_TSS	CD4pp_CD25__CD45RApp_Naive_Primary_Cells_Bivalent_Poised_TSS
Rectal_Smooth_Muscle_Bivalent_Poised_TSS	H1_BMP4_Derived_Mesendoderm_Cultured_Cells_Flanking_Bivalent_TSS_Enh
Aorta_Transcr_at_gene_5_and_3	CD4pp_CD25int_CD127pp_Tmem_Primary_Cells_Weak_transcription
ES_WA7_Cell_Line_Bivalent_Poised_TSS	Duodenum_Mucosa_Genic_enhancers
Fetal_Kidney_Bivalent_Poised_TSS	Brain_Substantia_Nigra_Flanking_Bivalent_TSS_Enh
Skeletal_Muscle_Female_Flanking_Active_TSS	Sigmoid_Colon_Genic_enhancers
NHEK_Epidermal_Keratinocytes_Flanking_Active_TSS	Mobilized_CD34_Primary_Cells_Female_Active_TSS
Peripheral_Blood_Mononuclear_Primary_Cells_Enhancers	NH_A_Astrocytes_Bivalent_Poised_TSS
Brain_Mid_Frontal_Lobe_Bivalent_Poised_TSS	H1_Derived_Neuronal_Progenitor_Cultured_Cells_Flanking_Active_TSS
Ovary_Genic_enhancers	H1_Cell_Line_Flanking_Bivalent_TSS_Enh
CD34_Primary_Cells_Transcr_at_gene_5_and_3	H1_Derived_Neuronal_Progenitor_Cultured_Cells_Genic_enhancers
Colonic_Mucosa_Transcr_at_gene_5_and_3	Brain_Angular_Gyrus_Flanking_Bivalent_TSS_Enh
Mobilized_CD34_Primary_Cells_Female_Active_TSS	Thymus_Flanking_Bivalent_TSS_Enh
Monocytes_CD14pp_RO01746_Flanking_Bivalent_TSS_Enh	CD4pp_CD25__CD45ROpp_Memory_Primary_Cells_Active_TSS
Brain_Anterior_Caudate_Bivalent_Poised_TSS	Fetal_Stomach_ZNF_genes_and_repeats
Gastric_Enhancers	CD4_Memory_Primary_Cells_Bivalent_Poised_TSS
Fetal_Heart_Transcr_at_gene_5_and_3	CD4_Naive_Primary_Cells_Bivalent_Poised_TSS
Fetal_Brain_Male_Transcr_at_gene_5_and_3	hESC_Derived_CD184pp_Endoderm_Cultured_Cells_Bivalent_Poised_TSS
Esophagus_ZNF_genes_and_repeats	Dnd41_TCell_Leukemia_Weak_transcription
Bone_Marrow_Derived_Mesenchymal_Stem_Cell_Cultured_Cells_Flanking_Active_TSS	Stomach_Smooth_Muscle_ZNF_genes_and_repeats
Small_Intestine_Weak_Repressed_PolyComb	Colon_Smooth_Muscle_Heterochromatin
CD4pp_CD25__CD45ROpp_Memory_Primary_Cells_Bivalent_Enhancer	Esophagus_Bivalent_Poised_TSS
HMEC_Mammary_Epithelial_Flanking_Active_TSS	HUES48_Cell_Line_Flanking_Bivalent_TSS_Enh
HSMMtube_Skeletal_Muscle_Myotubes_Derived_from_HSMM_Bivalent_Poised_TSS	CD4_Naive_Primary_Cells_Weak_transcription
Thymus_Bivalent_Poised_TSS	CD4pp_CD25__CD45ROpp_Memory_Primary_Cells_Genic_enhancers
4star_Bivalent_Enhancer	Muscle_Satellite_Cultured_Cells_Weak_transcription
Lung_Transcr_at_gene_5_and_3	Peripheral_Blood_Mononuclear_Primary_Cells_Bivalent_Poised_TSS
Fetal_Stomach_Bivalent_Enhancer	Fetal_Heart_Weak_transcription
CD3_Primary_Cells_Cord_BI_Bivalent_Poised_TSS	HSMM_Skeletal_Muscle_Myoblasts_Bivalent_Poised_TSS
Rectal_Mucosa.Donor_29_Bivalent_Poised_TSS	Stomach_Mucosa_Bivalent_Poised_TSS
Aorta_Enhancers	iPS_DF_6.9_Cell_Line_Genic_enhancers
Neurosphere_Cultured_Cells_Ganglionic_Eminence_Derived_Flanking_Active_TSS	iPS_DF_19.11_Cell_Line_Flanking_Bivalent_TSS_Enh
CD14_Primary_Cells_Flanking_Active_TSS	Fetal_Kidney_ZNF_genes_and_repeats
Muscle_Satellite_Cultured_Cells_Flanking_Active_TSS	CD4pp_CD25pp_CD127__Treg_Primary_Cells_Weak_transcription
Fetal_Kidney_Genic_enhancers	H1_Derived_Mesenchymal_Stem_Cells_Heterochromatin
Right_Atrium_Transcr_at_gene_5_and_3	CD8_Naive_Primary_Cells_Weak_transcription
CD4pp_CD25__CD45RApp_Naive_Primary_Cells_Flanking_Active_TSS	Adult_Liver_Flanking_Bivalent_TSS_Enh
CD56_Primary_Cells_Flanking_Active_TSS	4star_Flanking_Bivalent_TSS_Enh
Fetal_Adrenal_Gland_Bivalent_Enhancer	Fetal_Thymus_Heterochromatin
CD19_Primary_Cells_Cord_BI_Active_TSS	NHDF_Ad_Adult_Dermal_Fibroblasts_Weak_transcription
iPS_DF_6.9_Cell_Line_Enhancers	Fetal_Thymus_Bivalent_Poised_TSS
Brain_Inferior_Temporal_Lobe_Bivalent_Poised_TSS	Ovary_Genic_enhancers
Fetal_Stomach_Bivalent_Poised_TSS	CD34_Primary_Cells_Heterochromatin
Brain_Substantia_Nigra_Transcr_at_gene_5_and_3	Fetal_Intestine_Large_Heterochromatin
Adult_Liver_Bivalent_Enhancer	Rectal_Smooth_Muscle_Heterochromatin
Fetal_Brain_Male_Genic_enhancers	NHLF_Lung_Fibroblasts_ZNF_genes_and_repeats
Fetal_Stomach_Transcr_at_gene_5_and_3	ES_WA7_Cell_Line_ZNF_genes_and_repeats
Osteoblasts_Flanking_Active_TSS	H1_Derived_Neuronal_Progenitor_Cultured_Cells_ZNF_genes_and_repeats
Fetal_Thymus_Flanking_Active_TSS	Breast_vHMEC_Flanking_Bivalent_TSS_Enh
Rectal_Mucosa.Donor_31_Bivalent_Poised_TSS	Penis_Foreskin_Keratinocyte_Primary_Cells_skin02_Bivalent_Poised_TSS
K562_Leukemia_Flanking_Active_TSS	CD4pp_CD25__Th_Primary_Cells_Genic_enhancers
Penis_Foreskin_Keratinocyte_Primary_Cells_skin03_Flanking_Active_TSS	Fetal_Brain_Male_Genic_enhancers
A549_EtOH_0.02pct_Lung_Carcinoma_Flanking_Active_TSS	CD4pp_CD25__CD45RApp_Naive_Primary_Cells_Genic_enhancers
CD3_Primary_Cells_Peripheral_UW_Bivalent_Enhancer	Fetal_Lung_Weak_transcription
Brain_Angular_Gyrus_Transcr_at_gene_5_and_3	CD15_Primary_Cells_ZNF_genes_and_repeats
Brain_Germinal_Matrix_Bivalent_Poised_TSS	Fetal_Thymus_Flanking_Bivalent_TSS_Enh
Mobilized_CD34_Primary_Cells_Male_Active_TSS	CD4pp_CD25__CD45RApp_Naive_Primary_Cells_Flanking_Bivalent_TSS_Enh
H1_Derived_Neuronal_Progenitor_Cultured_Cells_ZNF_genes_and_repeats	Brain_Substantia_Nigra_Genic_enhancers
CD19_Primary_Cells_Peripheral_UW_Flanking_Active_TSS	CD19_Primary_Cells_Peripheral_UW_Flanking_Bivalent_TSS_Enh
NHLF_Lung_Fibroblasts_Bivalent_Poised_TSS	H1_Derived_Neuronal_Progenitor_Cultured_Cells_Active_TSS
Placenta_Amnion_Transcr_at_gene_5_and_3	CD34_Cultured_Cells_Flanking_Bivalent_TSS_Enh
H1_BMP4_Derived_Trophoblast_Cultured_Cells_ZNF_genes_and_repeats	iPS_20b_Cell_Line_Flanking_Active_TSS
hESC_Derived_CD56pp_Ectoderm_Cultured_Cells_Bivalent_Enhancer	Fetal_Intestine_Small_ZNF_genes_and_repeats
H9_Cell_Line_Genic_enhancers	4star_Flanking_Active_TSS
Small_Intestine_Transcr_at_gene_5_and_3	NH_A_Astrocytes_Weak_transcription
Penis_Foreskin_Fibroblast_Primary_Cells_skin01_Flanking_Active_TSS	iPS_DF_6.9_Cell_Line_Transcr_at_gene_5_and_3
H9_Cell_Line_Transcr_at_gene_5_and_3	Skeletal_Muscle_Male_Heterochromatin
HSMM_Skeletal_Muscle_Myoblasts_Bivalent_Poised_TSS	H9_Derived_Neuron_Cultured_Cells_Transcr_at_gene_5_and_3
Colon_Smooth_Muscle_Bivalent_Poised_TSS	Placenta_Amnion_Flanking_Active_TSS
Brain_Germinal_Matrix_Flanking_Active_TSS	Fetal_Intestine_Large_ZNF_genes_and_repeats
Aorta_ZNF_genes_and_repeats	Adipose_Nuclei_Genic_enhancers
Fetal_Muscle_Leg_Flanking_Active_TSS	IMR90_Cell_Line_ZNF_genes_and_repeats
Breast_Myoepithelial_Cells_Bivalent_Poised_TSS	Peripheral_Blood_Mononuclear_Primary_Cells_Flanking_Bivalent_TSS_Enh
H1_BMP4_Derived_Mesendoderm_Cultured_Cells_Transcr_at_gene_5_and_3	CD4pp_CD25__IL17__PMA_Ionomycin_stimulated_MACS_purified_Th_Primary_Cells_Flanking_Bivalent_TSS_Enh
Mesenchymal_Stem_Cell_Derived_Adipocyte_Cultured_Cells_Flanking_Active_TSS	CD4_Memory_Primary_Cells_Genic_enhancers
H1_Derived_Neuronal_Progenitor_Cultured_Cells_Genic_enhancers	Breast_vHMEC_Weak_transcription
NH_A_Astrocytes_Flanking_Active_TSS	Ovary_Flanking_Bivalent_TSS_Enh
Small_Intestine_Bivalent_Poised_TSS	H1_BMP4_Derived_Trophoblast_Cultured_Cells_Active_TSS
Aorta_Genic_enhancers	CD56_Primary_Cells_Active_TSS
CD34_Primary_Cells_Active_TSS	Brain_Hippocampus_Middle_Genic_enhancers
H1_Cell_Line_Bivalent_Enhancer	hESC_Derived_CD56pp_Ectoderm_Cultured_Cells_Genic_enhancers
Brain_Mid_Frontal_Lobe_Transcr_at_gene_5_and_3	hESC_Derived_CD56pp_Mesoderm_Cultured_Cells_Genic_enhancers
Brain_Inferior_Temporal_Lobe_Transcr_at_gene_5_and_3	CD3_Primary_Cells_Cord_BI_Weak_transcription
HSMMtube_Skeletal_Muscle_Myotubes_Derived_from_HSMM_Transcr_at_gene_5_and_3	Fetal_Heart_Genic_enhancers
HUVEC_Umbilical_Vein_Endothelial_Cells_Quiescent_Low	CD4_Memory_Primary_Cells_Weak_transcription
Duodenum_Mucosa_Flanking_Active_TSS	K562_Leukemia_Genic_enhancers
Brain_Hippocampus_Middle_Bivalent_Poised_TSS	H1_Derived_Mesenchymal_Stem_Cells_Active_TSS
Pancreas_Transcr_at_gene_5_and_3	Brain_Mid_Frontal_Lobe_ZNF_genes_and_repeats
CD14_Primary_Cells_Bivalent_Enhancer	CD8_Memory_Primary_Cells_Weak_transcription
Psoas_Muscle_Bivalent_Poised_TSS	CD4_Memory_Primary_Cells_Flanking_Bivalent_TSS_Enh
Neurosphere_Cultured_Cells_Cortex_Derived_Flanking_Bivalent_TSS_Enh	H1_BMP4_Derived_Mesendoderm_Cultured_Cells_Weak_transcription
CD4pp_CD25__CD45ROpp_Memory_Primary_Cells_Flanking_Active_TSS	Penis_Foreskin_Fibroblast_Primary_Cells_skin01_Weak_transcription
Rectal_Mucosa.Donor_31_Flanking_Active_TSS	Penis_Foreskin_Melanocyte_Primary_Cells_skin03_Bivalent_Poised_TSS
Right_Atrium_ZNF_genes_and_repeats	HSMM_Skeletal_Muscle_Myoblasts_Genic_enhancers
iPS_DF_19.11_Cell_Line_Transcr_at_gene_5_and_3	Psoas_Muscle_Flanking_Bivalent_TSS_Enh
CD4_Naive_Primary_Cells_Flanking_Active_TSS	H1_Derived_Mesenchymal_Stem_Cells_ZNF_genes_and_repeats
Fetal_Adrenal_Gland_Flanking_Bivalent_TSS_Enh	NHEK_Epidermal_Keratinocytes_ZNF_genes_and_repeats
NHDF_Ad_Adult_Dermal_Fibroblasts_Bivalent_Poised_TSS	CD4pp_CD25__IL17pp_PMA_Ionomcyin_stimulated_Th17_Primary_Cells_Transcr_at_gene_5_and_3
CD4pp_CD25pp_CD127__Treg_Primary_Cells_Flanking_Bivalent_TSS_Enh	NHDF_Ad_Adult_Dermal_Fibroblasts_Genic_enhancers
Pancreas_ZNF_genes_and_repeats	H9_Cell_Line_Flanking_Bivalent_TSS_Enh
Osteoblasts_Bivalent_Poised_TSS	HSMMtube_Skeletal_Muscle_Myotubes_Derived_from_HSMM_Genic_enhancers
Fetal_Heart_Bivalent_Enhancer	iPS_18_Cell_Line_Flanking_Bivalent_TSS_Enh
Breast_Myoepithelial_Cells_Bivalent_Enhancer	HUES6_Cell_Line_Weak_transcription
CD4pp_CD25__IL17pp_PMA_Ionomcyin_stimulated_Th17_Primary_Cells_Flanking_Active_TSS	Stomach_Smooth_Muscle_Heterochromatin
Psoas_Muscle_Genic_enhancers	CD4pp_CD25int_CD127pp_Tmem_Primary_Cells_Flanking_Bivalent_TSS_Enh
HUES48_Cell_Line_Bivalent_Enhancer	CD4pp_CD25__Th_Primary_Cells_Flanking_Bivalent_TSS_Enh
H1_BMP4_Derived_Mesendoderm_Cultured_Cells_ZNF_genes_and_repeats	CD19_Primary_Cells_Peripheral_UW_Heterochromatin
Pancreatic_Islets_Genic_enhancers	CD4pp_CD25__CD45RApp_Naive_Primary_Cells_Heterochromatin
Adipose_Derived_Mesenchymal_Stem_Cell_Cultured_Cells_Flanking_Active_TSS	Rectal_Smooth_Muscle_ZNF_genes_and_repeats
Fetal_Muscle_Leg_Flanking_Bivalent_TSS_Enh	CD4pp_CD25__CD45ROpp_Memory_Primary_Cells_Flanking_Bivalent_TSS_Enh
Fetal_Brain_Female_Flanking_Active_TSS	CD8_Naive_Primary_Cells_Flanking_Bivalent_TSS_Enh
CD8_Memory_Primary_Cells_Flanking_Active_TSS	Neurosphere_Cultured_Cells_Ganglionic_Eminence_Derived_Heterochromatin
Fetal_Adrenal_Gland_Flanking_Active_TSS	H1_Derived_Neuronal_Progenitor_Cultured_Cells_Repressed_PolyComb
iPS_18_Cell_Line_Bivalent_Enhancer	HUVEC_Umbilical_Vein_Endothelial_Cells_Weak_transcription
CD4pp_CD25__Th_Primary_Cells_Bivalent_Enhancer	Skeletal_Muscle_Female_Heterochromatin
Stomach_Mucosa_Bivalent_Enhancer	Aorta_Bivalent_Poised_TSS
Penis_Foreskin_Keratinocyte_Primary_Cells_skin03_Flanking_Bivalent_TSS_Enh	CD14_Primary_Cells_Active_TSS
Bone_Marrow_Derived_Mesenchymal_Stem_Cell_Cultured_Cells_Bivalent_Poised_TSS	CD34_Primary_Cells_Flanking_Bivalent_TSS_Enh
HUES64_Cell_Line_Bivalent_Enhancer	Penis_Foreskin_Melanocyte_Primary_Cells_skin03_Genic_enhancers
Penis_Foreskin_Keratinocyte_Primary_Cells_skin02_Bivalent_Poised_TSS	Penis_Foreskin_Keratinocyte_Primary_Cells_skin02_ZNF_genes_and_repeats
CD8_Naive_Primary_Cells_Bivalent_Enhancer	Brain_Anterior_Caudate_Genic_enhancers
CD4pp_CD25__IL17__PMA_Ionomycin_stimulated_MACS_purified_Th_Primary_Cells_Bivalent_Enhancer	H1_BMP4_Derived_Mesendoderm_Cultured_Cells_Active_TSS
CD8_Naive_Primary_Cells_Flanking_Active_TSS	Left_Ventricle_Flanking_Bivalent_TSS_Enh
Penis_Foreskin_Keratinocyte_Primary_Cells_skin02_Flanking_Active_TSS	iPS_DF_6.9_Cell_Line_Heterochromatin
H1_Derived_Neuronal_Progenitor_Cultured_Cells_Bivalent_Poised_TSS	Left_Ventricle_ZNF_genes_and_repeats
Small_Intestine_Genic_enhancers	Small_Intestine_Genic_enhancers
H9_Derived_Neuronal_Progenitor_Cultured_Cells_Flanking_Active_TSS	Breast_vHMEC_Genic_enhancers
Brain_Hippocampus_Middle_Flanking_Active_TSS	Small_Intestine_Active_TSS
Fetal_Thymus_Bivalent_Enhancer	Thymus_ZNF_genes_and_repeats
CD4_Memory_Primary_Cells_Flanking_Active_TSS	H1_Derived_Neuronal_Progenitor_Cultured_Cells_Bivalent_Enhancer
HepG2_Hepatocellular_Carcinoma_Bivalent_Enhancer	H1_BMP4_Derived_Trophoblast_Cultured_Cells_Flanking_Bivalent_TSS_Enh
H9_Derived_Neuronal_Progenitor_Cultured_Cells_Bivalent_Poised_TSS	Thymus_Weak_transcription
iPS_DF_6.9_Cell_Line_Genic_enhancers	HSMMtube_Skeletal_Muscle_Myotubes_Derived_from_HSMM_ZNF_genes_and_repeats
Penis_Foreskin_Melanocyte_Primary_Cells_skin03_Flanking_Bivalent_TSS_Enh	Fetal_Kidney_Genic_enhancers
Rectal_Mucosa.Donor_29_Flanking_Active_TSS	Fetal_Heart_Active_TSS
Fetal_Lung_Bivalent_Poised_TSS	Rectal_Smooth_Muscle_Weak_transcription
Spleen_Transcr_at_gene_5_and_3	HMEC_Mammary_Epithelial_Heterochromatin
H9_Derived_Neuronal_Progenitor_Cultured_Cells_Bivalent_Enhancer	H9_Derived_Neuronal_Progenitor_Cultured_Cells_Transcr_at_gene_5_and_3
CD4_Memory_Primary_Cells_Bivalent_Enhancer	Osteoblasts_Genic_enhancers
H1_BMP4_Derived_Trophoblast_Cultured_Cells_Transcr_at_gene_5_and_3	Brain_Mid_Frontal_Lobe_Heterochromatin
Fetal_Thymus_Bivalent_Poised_TSS	H9_Derived_Neuron_Cultured_Cells_Flanking_Bivalent_TSS_Enh
Fetal_Lung_Bivalent_Enhancer	Stomach_Mucosa_Heterochromatin
HUES6_Cell_Line_Bivalent_Enhancer	CD19_Primary_Cells_Cord_BI_Weak_transcription
ES_I3_Cell_Line_Bivalent_Enhancer	Brain_Inferior_Temporal_Lobe_Heterochromatin
iPS_DF_19.11_Cell_Line_Bivalent_Enhancer	Bone_Marrow_Derived_Mesenchymal_Stem_Cell_Cultured_Cells_Genic_enhancers
H9_Derived_Neuron_Cultured_Cells_Bivalent_Enhancer	ES_I3_Cell_Line_Transcr_at_gene_5_and_3
Fetal_Muscle_Leg_Bivalent_Poised_TSS	Skeletal_Muscle_Female_Genic_enhancers
CD4pp_CD25__IL17pp_PMA_Ionomcyin_stimulated_Th17_Primary_Cells_Active_TSS	Rectal_Smooth_Muscle_Genic_enhancers
CD8_Memory_Primary_Cells_Bivalent_Enhancer	NH_A_Astrocytes_Flanking_Bivalent_TSS_Enh
Penis_Foreskin_Melanocyte_Primary_Cells_skin03_Flanking_Active_TSS	CD3_Primary_Cells_Peripheral_UW_Weak_transcription
Duodenum_Mucosa_Bivalent_Poised_TSS	H9_Cell_Line_Transcr_at_gene_5_and_3
Right_Atrium_Genic_enhancers	H1_Derived_Neuronal_Progenitor_Cultured_Cells_Flanking_Bivalent_TSS_Enh
Fetal_Muscle_Trunk_Flanking_Active_TSS	Penis_Foreskin_Keratinocyte_Primary_Cells_skin03_ZNF_genes_and_repeats
Brain_Substantia_Nigra_Bivalent_Poised_TSS	HSMM_Skeletal_Muscle_Myoblasts_ZNF_genes_and_repeats
Neurosphere_Cultured_Cells_Cortex_Derived_Transcr_at_gene_5_and_3	Fetal_Adrenal_Gland_Genic_enhancers
H1_Derived_Mesenchymal_Stem_Cells_Transcr_at_gene_5_and_3	CD4pp_CD25__CD45RApp_Naive_Primary_Cells_Transcr_at_gene_5_and_3
Stomach_Mucosa_Bivalent_Poised_TSS	Brain_Angular_Gyrus_Genic_enhancers
NH_A_Astrocytes_Bivalent_Poised_TSS	Psoas_Muscle_Weak_transcription
Dnd41_TCell_Leukemia_Weak_Repressed_PolyComb	HMEC_Mammary_Epithelial_ZNF_genes_and_repeats
Fetal_Kidney_Transcr_at_gene_5_and_3	iPS_DF_6.9_Cell_Line_ZNF_genes_and_repeats
CD4_Naive_Primary_Cells_Bivalent_Enhancer	Psoas_Muscle_Genic_enhancers
iPS_18_Cell_Line_Flanking_Active_TSS	Colon_Smooth_Muscle_ZNF_genes_and_repeats
Skeletal_Muscle_Male_Bivalent_Enhancer	CD4pp_CD25__CD45RApp_Naive_Primary_Cells_ZNF_genes_and_repeats
HUES6_Cell_Line_Flanking_Active_TSS	iPS_DF_6.9_Cell_Line_Flanking_Bivalent_TSS_Enh
Neurosphere_Cultured_Cells_Ganglionic_Eminence_Derived_Flanking_Bivalent_TSS_Enh	H1_BMP4_Derived_Mesendoderm_Cultured_Cells_ZNF_genes_and_repeats
Fetal_Placenta_Flanking_Active_TSS	H9_Derived_Neuronal_Progenitor_Cultured_Cells_Flanking_Bivalent_TSS_Enh
Neurosphere_Cultured_Cells_Cortex_Derived_Bivalent_Enhancer	A549_EtOH_0.02pct_Lung_Carcinoma_Genic_enhancers
Thymus_Flanking_Active_TSS	Pancreatic_Islets_Weak_transcription
iPS_DF_19.11_Cell_Line_Flanking_Bivalent_TSS_Enh	Brain_Anterior_Caudate_ZNF_genes_and_repeats
Mesenchymal_Stem_Cell_Derived_Adipocyte_Cultured_Cells_Bivalent_Poised_TSS	Dnd41_TCell_Leukemia_Active_TSS
Lung_Bivalent_Enhancer	H1_BMP4_Derived_Mesendoderm_Cultured_Cells_Flanking_Active_TSS
Rectal_Smooth_Muscle_Flanking_Active_TSS	Muscle_Satellite_Cultured_Cells_Genic_enhancers
iPS_15b_Cell_Line_Bivalent_Enhancer	CD19_Primary_Cells_Peripheral_UW_Active_TSS
Placenta_Amnion_Bivalent_Enhancer	Fetal_Adrenal_Gland_ZNF_genes_and_repeats
Adipose_Nuclei_Flanking_Bivalent_TSS_Enh	Brain_Substantia_Nigra_Heterochromatin
iPS_DF_6.9_Cell_Line_ZNF_genes_and_repeats	Stomach_Mucosa_ZNF_genes_and_repeats
HUES6_Cell_Line_Quiescent_Low	Peripheral_Blood_Mononuclear_Primary_Cells_ZNF_genes_and_repeats
Fetal_Muscle_Trunk_Flanking_Bivalent_TSS_Enh	Fetal_Kidney_Weak_transcription
Penis_Foreskin_Fibroblast_Primary_Cells_skin01_Flanking_Bivalent_TSS_Enh	H1_BMP4_Derived_Mesendoderm_Cultured_Cells_Bivalent_Poised_TSS
Brain_Cingulate_Gyrus_Flanking_Active_TSS	hESC_Derived_CD56pp_Ectoderm_Cultured_Cells_Weak_transcription
hESC_Derived_CD184pp_Endoderm_Cultured_Cells_Bivalent_Enhancer	HMEC_Mammary_Epithelial_Flanking_Bivalent_TSS_Enh
CD4pp_CD25int_CD127pp_Tmem_Primary_Cells_Flanking_Active_TSS	Mobilized_CD34_Primary_Cells_Female_Heterochromatin
Fetal_Intestine_Small_Bivalent_Enhancer	A549_EtOH_0.02pct_Lung_Carcinoma_ZNF_genes_and_repeats
NHEK_Epidermal_Keratinocytes_Bivalent_Poised_TSS	HUVEC_Umbilical_Vein_Endothelial_Cells_Genic_enhancers
Mobilized_CD34_Primary_Cells_Female_Bivalent_Enhancer	H1_Derived_Neuronal_Progenitor_Cultured_Cells_Bivalent_Poised_TSS
Mobilized_CD34_Primary_Cells_Male_Quiescent_Low	HepG2_Hepatocellular_Carcinoma_Genic_enhancers
Colonic_Mucosa_Flanking_Active_TSS	NHDF_Ad_Adult_Dermal_Fibroblasts_ZNF_genes_and_repeats
Duodenum_Smooth_Muscle_Flanking_Active_TSS	Colonic_Mucosa_ZNF_genes_and_repeats
Left_Ventricle_Bivalent_Poised_TSS	CD14_Primary_Cells_ZNF_genes_and_repeats
iPS_20b_Cell_Line_Flanking_Active_TSS	Aorta_ZNF_genes_and_repeats
iPS_DF_6.9_Cell_Line_Transcr_at_gene_5_and_3	CD4_Naive_Primary_Cells_Heterochromatin
Fetal_Lung_Flanking_Active_TSS	Dnd41_TCell_Leukemia_Heterochromatin
CD15_Primary_Cells_Flanking_Bivalent_TSS_Enh	GM12878_Lymphoblastoid_Genic_enhancers
HUES48_Cell_Line_Flanking_Active_TSS	Brain_Substantia_Nigra_ZNF_genes_and_repeats
Fetal_Adrenal_Gland_Bivalent_Poised_TSS	Ovary_ZNF_genes_and_repeats
Penis_Foreskin_Keratinocyte_Primary_Cells_skin03_Quiescent_Low	Fetal_Stomach_Weak_transcription
Brain_Germinal_Matrix_Flanking_Bivalent_TSS_Enh	Brain_Inferior_Temporal_Lobe_ZNF_genes_and_repeats
CD4pp_CD25__IL17pp_PMA_Ionomcyin_stimulated_Th17_Primary_Cells_Bivalent_Enhancer	Placenta_Amnion_Active_TSS
Penis_Foreskin_Fibroblast_Primary_Cells_skin02_Flanking_Active_TSS	Duodenum_Smooth_Muscle_Genic_enhancers
4star_Bivalent_Poised_TSS	Neurosphere_Cultured_Cells_Cortex_Derived_Heterochromatin
Breast_Myoepithelial_Cells_Flanking_Active_TSS	Fetal_Brain_Male_ZNF_genes_and_repeats
CD3_Primary_Cells_Peripheral_UW_Flanking_Bivalent_TSS_Enh	Rectal_Mucosa.Donor_29_ZNF_genes_and_repeats
Brain_Inferior_Temporal_Lobe_Flanking_Active_TSS	Colonic_Mucosa_Heterochromatin
CD14_Primary_Cells_Quiescent_Low	ES_WA7_Cell_Line_Weak_transcription
Brain_Anterior_Caudate_Flanking_Active_TSS	Duodenum_Smooth_Muscle_Heterochromatin
Right_Atrium_Bivalent_Poised_TSS	GM12878_Lymphoblastoid_ZNF_genes_and_repeats
HSMM_Skeletal_Muscle_Myoblasts_Flanking_Active_TSS	CD4pp_CD25__CD45ROpp_Memory_Primary_Cells_Weak_transcription
CD34_Primary_Cells_Bivalent_Enhancer	CD56_Primary_Cells_ZNF_genes_and_repeats
IMR90_Cell_Line_Bivalent_Poised_TSS	Brain_Cingulate_Gyrus_Heterochromatin
CD4pp_CD25__Th_Primary_Cells_Flanking_Bivalent_TSS_Enh	Brain_Germinal_Matrix_ZNF_genes_and_repeats
Pancreas_Flanking_Bivalent_TSS_Enh	Muscle_Satellite_Cultured_Cells_ZNF_genes_and_repeats
Aorta_Bivalent_Poised_TSS	CD19_Primary_Cells_Peripheral_UW_ZNF_genes_and_repeats
Chondrocytes_from_Bone_Marrow_Derived_Mesenchymal_Stem_Cell_Cultured_Cells_Quiescent_Low	Brain_Angular_Gyrus_ZNF_genes_and_repeats
Stomach_Smooth_Muscle_Bivalent_Poised_TSS	Penis_Foreskin_Melanocyte_Primary_Cells_skin03_ZNF_genes_and_repeats
Mesenchymal_Stem_Cell_Derived_Adipocyte_Cultured_Cells_Quiescent_Low	Mesenchymal_Stem_Cell_Derived_Adipocyte_Cultured_Cells_Heterochromatin
iPS_20b_Cell_Line_Bivalent_Enhancer	hESC_Derived_CD56pp_Mesoderm_Cultured_Cells_Bivalent_Poised_TSS
Skeletal_Muscle_Female_Flanking_Bivalent_TSS_Enh	CD4pp_CD25__IL17pp_PMA_Ionomcyin_stimulated_Th17_Primary_Cells_ZNF_genes_and_repeats
Fetal_Muscle_Trunk_Bivalent_Poised_TSS	Adult_Liver_Genic_enhancers
Sigmoid_Colon_Transcr_at_gene_5_and_3	Duodenum_Mucosa_ZNF_genes_and_repeats
H9_Derived_Neuron_Cultured_Cells_Flanking_Bivalent_TSS_Enh	NH_A_Astrocytes_Genic_enhancers
Sigmoid_Colon_Bivalent_Poised_TSS	Pancreatic_Islets_ZNF_genes_and_repeats
CD34_Cultured_Cells_Bivalent_Enhancer	Right_Ventricle_ZNF_genes_and_repeats
Fetal_Stomach_Flanking_Bivalent_TSS_Enh	Brain_Hippocampus_Middle_ZNF_genes_and_repeats
Penis_Foreskin_Fibroblast_Primary_Cells_skin01_Bivalent_Enhancer	Aorta_Weak_transcription
Fetal_Thymus_Flanking_Bivalent_TSS_Enh	CD4pp_CD25__IL17__PMA_Ionomycin_stimulated_MACS_purified_Th_Primary_Cells_Genic_enhancers
ES_WA7_Cell_Line_Transcr_at_gene_5_and_3	4star_Transcr_at_gene_5_and_3
Mobilized_CD34_Primary_Cells_Male_Bivalent_Enhancer	CD8_Memory_Primary_Cells_Heterochromatin
Colon_Smooth_Muscle_Flanking_Active_TSS	hESC_Derived_CD56pp_Ectoderm_Cultured_Cells_Flanking_Bivalent_TSS_Enh
HUES64_Cell_Line_Flanking_Active_TSS	Brain_Angular_Gyrus_Heterochromatin
Colonic_Mucosa_Bivalent_Poised_TSS	Right_Atrium_Transcr_at_gene_5_and_3
IMR90_Cell_Line_Flanking_Active_TSS	Monocytes_CD14pp_RO01746_ZNF_genes_and_repeats
Penis_Foreskin_Fibroblast_Primary_Cells_skin02_Quiescent_Low	Osteoblasts_ZNF_genes_and_repeats
Skeletal_Muscle_Male_Bivalent_Poised_TSS	NH_A_Astrocytes_ZNF_genes_and_repeats
NHDF_Ad_Adult_Dermal_Fibroblasts_Flanking_Active_TSS	Rectal_Mucosa.Donor_29_Heterochromatin
Fetal_Intestine_Large_Bivalent_Enhancer	Sigmoid_Colon_ZNF_genes_and_repeats
Skeletal_Muscle_Female_Bivalent_Enhancer	H9_Cell_Line_Genic_enhancers
Skeletal_Muscle_Female_Bivalent_Poised_TSS	iPS_DF_19.11_Cell_Line_Bivalent_Poised_TSS
Stomach_Smooth_Muscle_Flanking_Bivalent_TSS_Enh	HepG2_Hepatocellular_Carcinoma_ZNF_genes_and_repeats
Esophagus_Bivalent_Poised_TSS	CD4_Naive_Primary_Cells_ZNF_genes_and_repeats
H9_Derived_Neuron_Cultured_Cells_Bivalent_Poised_TSS	CD34_Cultured_Cells_ZNF_genes_and_repeats
Penis_Foreskin_Melanocyte_Primary_Cells_skin01_Flanking_Active_TSS	hESC_Derived_CD56pp_Ectoderm_Cultured_Cells_Transcr_at_gene_5_and_3
CD19_Primary_Cells_Cord_BI_Bivalent_Enhancer	Brain_Hippocampus_Middle_Heterochromatin
CD14_Primary_Cells_Flanking_Bivalent_TSS_Enh	Brain_Anterior_Caudate_Heterochromatin
CD4pp_CD25int_CD127pp_Tmem_Primary_Cells_Flanking_Bivalent_TSS_Enh	iPS_DF_6.9_Cell_Line_Bivalent_Poised_TSS
Skeletal_Muscle_Male_Flanking_Bivalent_TSS_Enh	Skeletal_Muscle_Female_ZNF_genes_and_repeats
Fetal_Brain_Male_Flanking_Active_TSS	Left_Ventricle_Genic_enhancers
Penis_Foreskin_Melanocyte_Primary_Cells_skin03_Bivalent_Enhancer	Fetal_Muscle_Leg_ZNF_genes_and_repeats
Fetal_Placenta_Bivalent_Poised_TSS	Small_Intestine_Weak_transcription
Brain_Angular_Gyrus_Flanking_Active_TSS	NHEK_Epidermal_Keratinocytes_Heterochromatin
Brain_Mid_Frontal_Lobe_Flanking_Active_TSS	hESC_Derived_CD56pp_Ectoderm_Cultured_Cells_ZNF_genes_and_repeats
Ovary_Transcr_at_gene_5_and_3	Penis_Foreskin_Melanocyte_Primary_Cells_skin03_Heterochromatin
Penis_Foreskin_Keratinocyte_Primary_Cells_skin02_Flanking_Bivalent_TSS_Enh	CD4pp_CD25int_CD127pp_Tmem_Primary_Cells_Heterochromatin
CD4pp_CD25__CD45RApp_Naive_Primary_Cells_Flanking_Bivalent_TSS_Enh	Placenta_Amnion_Flanking_Bivalent_TSS_Enh
GM12878_Lymphoblastoid_Bivalent_Poised_TSS	Adipose_Nuclei_ZNF_genes_and_repeats
Adipose_Nuclei_Bivalent_Enhancer	Brain_Cingulate_Gyrus_ZNF_genes_and_repeats
HepG2_Hepatocellular_Carcinoma_Flanking_Bivalent_TSS_Enh	hESC_Derived_CD184pp_Endoderm_Cultured_Cells_Genic_enhancers
Peripheral_Blood_Mononuclear_Primary_Cells_Active_TSS	Adipose_Nuclei_Heterochromatin
CD8_Naive_Primary_Cells_Bivalent_Poised_TSS	Adipose_Derived_Mesenchymal_Stem_Cell_Cultured_Cells_Genic_enhancers
HSMMtube_Skeletal_Muscle_Myotubes_Derived_from_HSMM_Flanking_Active_TSS	Breast_vHMEC_ZNF_genes_and_repeats
CD4pp_CD25__CD45RApp_Naive_Primary_Cells_Bivalent_Enhancer	Fetal_Heart_ZNF_genes_and_repeats
iPS_DF_6.9_Cell_Line_Bivalent_Enhancer	Duodenum_Smooth_Muscle_ZNF_genes_and_repeats
NHLF_Lung_Fibroblasts_Flanking_Active_TSS	Chondrocytes_from_Bone_Marrow_Derived_Mesenchymal_Stem_Cell_Cultured_Cells_Genic_enhancers
H1_Derived_Mesenchymal_Stem_Cells_Bivalent_Enhancer	4star_ZNF_genes_and_repeats
CD34_Cultured_Cells_Flanking_Bivalent_TSS_Enh	H1_BMP4_Derived_Mesendoderm_Cultured_Cells_Strong_transcription
Brain_Hippocampus_Middle_Flanking_Bivalent_TSS_Enh	Muscle_Satellite_Cultured_Cells_Heterochromatin
Gastric_Transcr_at_gene_5_and_3	Fetal_Brain_Female_ZNF_genes_and_repeats
Fetal_Heart_Flanking_Active_TSS	Fetal_Intestine_Small_Heterochromatin
Penis_Foreskin_Fibroblast_Primary_Cells_skin02_Flanking_Bivalent_TSS_Enh	hESC_Derived_CD184pp_Endoderm_Cultured_Cells_Heterochromatin
Colonic_Mucosa_Flanking_Bivalent_TSS_Enh	Chondrocytes_from_Bone_Marrow_Derived_Mesenchymal_Stem_Cell_Cultured_Cells_ZNF_genes_and_repeats
ES_WA7_Cell_Line_Bivalent_Enhancer	H1_Cell_Line_Heterochromatin
CD4pp_CD25__IL17__PMA_Ionomycin_stimulated_MACS_purified_Th_Primary_Cells_Flanking_Bivalent_TSS_Enh	NHLF_Lung_Fibroblasts_Heterochromatin
CD3_Primary_Cells_Cord_BI_Flanking_Bivalent_TSS_Enh	Rectal_Mucosa.Donor_31_ZNF_genes_and_repeats
Gastric_Flanking_Bivalent_TSS_Enh	CD8_Memory_Primary_Cells_ZNF_genes_and_repeats
Chondrocytes_from_Bone_Marrow_Derived_Mesenchymal_Stem_Cell_Cultured_Cells_Flanking_Bivalent_TSS_Enh	Adult_Liver_ZNF_genes_and_repeats
Penis_Foreskin_Keratinocyte_Primary_Cells_skin03_Bivalent_Poised_TSS	hESC_Derived_CD56pp_Mesoderm_Cultured_Cells_Flanking_Bivalent_TSS_Enh
hESC_Derived_CD184pp_Endoderm_Cultured_Cells_Quiescent_Low	CD8_Naive_Primary_Cells_ZNF_genes_and_repeats
HUVEC_Umbilical_Vein_Endothelial_Cells_Flanking_Bivalent_TSS_Enh	ES_WA7_Cell_Line_Heterochromatin
Sigmoid_Colon_Bivalent_Enhancer	CD4pp_CD25__Th_Primary_Cells_Heterochromatin
4star_Flanking_Bivalent_TSS_Enh	iPS_15b_Cell_Line_Transcr_at_gene_5_and_3
Fetal_Intestine_Large_Flanking_Active_TSS	ES_I3_Cell_Line_Heterochromatin
NHEK_Epidermal_Keratinocytes_Flanking_Bivalent_TSS_Enh	CD4pp_CD25int_CD127pp_Tmem_Primary_Cells_ZNF_genes_and_repeats
Fetal_Stomach_Flanking_Active_TSS	hESC_Derived_CD56pp_Mesoderm_Cultured_Cells_ZNF_genes_and_repeats
Right_Ventricle_Flanking_Active_TSS	Fetal_Muscle_Trunk_ZNF_genes_and_repeats
Esophagus_Bivalent_Enhancer	CD3_Primary_Cells_Peripheral_UW_ZNF_genes_and_repeats
Adipose_Derived_Mesenchymal_Stem_Cell_Cultured_Cells_Bivalent_Enhancer	CD8_Naive_Primary_Cells_Heterochromatin
CD56_Primary_Cells_Flanking_Bivalent_TSS_Enh	CD4_Memory_Primary_Cells_ZNF_genes_and_repeats
Fetal_Intestine_Small_Flanking_Active_TSS	iPS_15b_Cell_Line_Genic_enhancers
ES_WA7_Cell_Line_ZNF_genes_and_repeats	Breast_Myoepithelial_Cells_ZNF_genes_and_repeats
H1_Derived_Neuronal_Progenitor_Cultured_Cells_Transcr_at_gene_5_and_3	Adult_Liver_Heterochromatin
Duodenum_Mucosa_Flanking_Bivalent_TSS_Enh	Right_Ventricle_Heterochromatin
Brain_Substantia_Nigra_Flanking_Active_TSS	CD3_Primary_Cells_Peripheral_UW_Heterochromatin
H1_BMP4_Derived_Mesendoderm_Cultured_Cells_Genic_enhancers	Small_Intestine_ZNF_genes_and_repeats
IMR90_Cell_Line_Bivalent_Enhancer	CD4pp_CD25pp_CD127__Treg_Primary_Cells_ZNF_genes_and_repeats
Right_Ventricle_Bivalent_Poised_TSS	hESC_Derived_CD56pp_Ectoderm_Cultured_Cells_Heterochromatin
Chondrocytes_from_Bone_Marrow_Derived_Mesenchymal_Stem_Cell_Cultured_Cells_Bivalent_Poised_TSS	Mesenchymal_Stem_Cell_Derived_Adipocyte_Cultured_Cells_ZNF_genes_and_repeats
HUES6_Cell_Line_Flanking_Bivalent_TSS_Enh	hESC_Derived_CD184pp_Endoderm_Cultured_Cells_Flanking_Bivalent_TSS_Enh
CD4pp_CD25int_CD127pp_Tmem_Primary_Cells_Bivalent_Poised_TSS	CD4_Memory_Primary_Cells_Heterochromatin
CD4pp_CD25int_CD127pp_Tmem_Primary_Cells_Bivalent_Enhancer	CD4pp_CD25__Th_Primary_Cells_ZNF_genes_and_repeats
Peripheral_Blood_Mononuclear_Primary_Cells_Bivalent_Poised_TSS	Dnd41_TCell_Leukemia_ZNF_genes_and_repeats
hESC_Derived_CD56pp_Mesoderm_Cultured_Cells_Bivalent_Enhancer	Neurosphere_Cultured_Cells_Cortex_Derived_ZNF_genes_and_repeats
CD34_Primary_Cells_Flanking_Bivalent_TSS_Enh	iPS_15b_Cell_Line_ZNF_genes_and_repeats
K562_Leukemia_Bivalent_Poised_TSS	H1_Cell_Line_ZNF_genes_and_repeats
Fetal_Intestine_Small_Flanking_Bivalent_TSS_Enh	CD4pp_CD25__CD45ROpp_Memory_Primary_Cells_ZNF_genes_and_repeats
Penis_Foreskin_Keratinocyte_Primary_Cells_skin03_Bivalent_Enhancer	Fetal_Stomach_Heterochromatin
Fetal_Placenta_Flanking_Bivalent_TSS_Enh	Bone_Marrow_Derived_Mesenchymal_Stem_Cell_Cultured_Cells_Heterochromatin
iPS_18_Cell_Line_Flanking_Bivalent_TSS_Enh	H9_Derived_Neuron_Cultured_Cells_ZNF_genes_and_repeats
Duodenum_Smooth_Muscle_Flanking_Bivalent_TSS_Enh	H1_BMP4_Derived_Mesendoderm_Cultured_Cells_Heterochromatin
Muscle_Satellite_Cultured_Cells_Bivalent_Poised_TSS	Mobilized_CD34_Primary_Cells_Male_Heterochromatin
Penis_Foreskin_Melanocyte_Primary_Cells_skin03_Quiescent_Low	Fetal_Lung_ZNF_genes_and_repeats
H9_Cell_Line_Bivalent_Enhancer	Mesenchymal_Stem_Cell_Derived_Adipocyte_Cultured_Cells_Genic_enhancers
Thymus_Flanking_Bivalent_TSS_Enh	Placenta_Amnion_Heterochromatin
CD15_Primary_Cells_Bivalent_Enhancer	ES_I3_Cell_Line_ZNF_genes_and_repeats
HMEC_Mammary_Epithelial_Flanking_Bivalent_TSS_Enh	H1_Cell_Line_Transcr_at_gene_5_and_3
CD19_Primary_Cells_Peripheral_UW_Flanking_Bivalent_TSS_Enh	iPS_DF_19.11_Cell_Line_Strong_transcription
Monocytes_CD14pp_RO01746_Bivalent_Enhancer	4star_Genic_enhancers
H1_Derived_Neuronal_Progenitor_Cultured_Cells_Bivalent_Enhancer	HUES6_Cell_Line_Heterochromatin
Breast_vHMEC_Bivalent_Poised_TSS	CD15_Primary_Cells_Heterochromatin
Breast_Myoepithelial_Cells_Flanking_Bivalent_TSS_Enh	H9_Cell_Line_Bivalent_Poised_TSS
Pancreas_Flanking_Active_TSS	Fetal_Adrenal_Gland_Heterochromatin
iPS_15b_Cell_Line_Flanking_Active_TSS	Psoas_Muscle_ZNF_genes_and_repeats
Penis_Foreskin_Fibroblast_Primary_Cells_skin01_Bivalent_Poised_TSS	Bone_Marrow_Derived_Mesenchymal_Stem_Cell_Cultured_Cells_ZNF_genes_and_repeats
CD4pp_CD25__IL17__PMA_Ionomycin_stimulated_MACS_purified_Th_Primary_Cells_Bivalent_Poised_TSS	H1_Cell_Line_Weak_transcription
Penis_Foreskin_Melanocyte_Primary_Cells_skin03_Bivalent_Poised_TSS	ES_I3_Cell_Line_Weak_transcription
Breast_Myoepithelial_Cells_Quiescent_Low	Peripheral_Blood_Mononuclear_Primary_Cells_Heterochromatin
H1_BMP4_Derived_Trophoblast_Cultured_Cells_Bivalent_Enhancer	HUES6_Cell_Line_Transcr_at_gene_5_and_3
Ovary_Bivalent_Poised_TSS	ES_I3_Cell_Line_Genic_enhancers
Muscle_Satellite_Cultured_Cells_Bivalent_Enhancer	Fetal_Heart_Heterochromatin
Penis_Foreskin_Keratinocyte_Primary_Cells_skin02_Bivalent_Enhancer	Small_Intestine_Heterochromatin
H1_Cell_Line_Flanking_Bivalent_TSS_Enh	Left_Ventricle_Heterochromatin
Monocytes_CD14pp_RO01746_Bivalent_Poised_TSS	H9_Derived_Neuronal_Progenitor_Cultured_Cells_ZNF_genes_and_repeats
Rectal_Mucosa.Donor_31_Bivalent_Enhancer	CD4pp_CD25__IL17__PMA_Ionomycin_stimulated_MACS_purified_Th_Primary_Cells_ZNF_genes_and_repeats
Brain_Angular_Gyrus_Bivalent_Enhancer	HUVEC_Umbilical_Vein_Endothelial_Cells_ZNF_genes_and_repeats
Fetal_Brain_Female_Flanking_Bivalent_TSS_Enh	Neurosphere_Cultured_Cells_Ganglionic_Eminence_Derived_ZNF_genes_and_repeats
H1_Cell_Line_Flanking_Active_TSS	HUES64_Cell_Line_Heterochromatin
NHDF_Ad_Adult_Dermal_Fibroblasts_Bivalent_Enhancer	CD4pp_CD25__IL17__PMA_Ionomycin_stimulated_MACS_purified_Th_Primary_Cells_Heterochromatin
Duodenum_Mucosa_Bivalent_Enhancer	Adipose_Derived_Mesenchymal_Stem_Cell_Cultured_Cells_ZNF_genes_and_repeats
Left_Ventricle_Bivalent_Enhancer	HUES6_Cell_Line_ZNF_genes_and_repeats
Adipose_Derived_Mesenchymal_Stem_Cell_Cultured_Cells_Quiescent_Low	NHDF_Ad_Adult_Dermal_Fibroblasts_Heterochromatin
Chondrocytes_from_Bone_Marrow_Derived_Mesenchymal_Stem_Cell_Cultured_Cells_Bivalent_Enhancer	Osteoblasts_Heterochromatin
CD4pp_CD25pp_CD127__Treg_Primary_Cells_Bivalent_Enhancer	Chondrocytes_from_Bone_Marrow_Derived_Mesenchymal_Stem_Cell_Cultured_Cells_Heterochromatin
hESC_Derived_CD56pp_Ectoderm_Cultured_Cells_Flanking_Active_TSS	Fetal_Brain_Male_Heterochromatin
Neurosphere_Cultured_Cells_Ganglionic_Eminence_Derived_Bivalent_Enhancer	HUES64_Cell_Line_Transcr_at_gene_5_and_3
Breast_vHMEC_Bivalent_Enhancer	CD4pp_CD25__IL17pp_PMA_Ionomcyin_stimulated_Th17_Primary_Cells_Heterochromatin
CD19_Primary_Cells_Cord_BI_Flanking_Bivalent_TSS_Enh	CD19_Primary_Cells_Cord_BI_ZNF_genes_and_repeats
NHEK_Epidermal_Keratinocytes_Bivalent_Enhancer	Pancreas_Quiescent_Low
Gastric_Repressed_PolyComb	iPS_20b_Cell_Line_Heterochromatin
NH_A_Astrocytes_Bivalent_Enhancer	Pancreatic_Islets_Heterochromatin
GM12878_Lymphoblastoid_Bivalent_Enhancer	hESC_Derived_CD184pp_Endoderm_Cultured_Cells_ZNF_genes_and_repeats
Penis_Foreskin_Fibroblast_Primary_Cells_skin02_Bivalent_Enhancer	Rectal_Mucosa.Donor_31_Heterochromatin
Neurosphere_Cultured_Cells_Ganglionic_Eminence_Derived_Bivalent_Poised_TSS	Spleen_Strong_transcription
H1_Derived_Mesenchymal_Stem_Cells_Quiescent_Low	HUES48_Cell_Line_Transcr_at_gene_5_and_3
Dnd41_TCell_Leukemia_Bivalent_Enhancer	CD4pp_CD25__CD45ROpp_Memory_Primary_Cells_Heterochromatin
Brain_Hippocampus_Middle_Bivalent_Enhancer	Mobilized_CD34_Primary_Cells_Male_ZNF_genes_and_repeats
hESC_Derived_CD184pp_Endoderm_Cultured_Cells_Flanking_Active_TSS	Fetal_Lung_Heterochromatin
K562_Leukemia_Bivalent_Enhancer	Brain_Germinal_Matrix_Heterochromatin
HUVEC_Umbilical_Vein_Endothelial_Cells_Bivalent_Enhancer	CD34_Primary_Cells_ZNF_genes_and_repeats
iPS_DF_19.11_Cell_Line_Bivalent_Poised_TSS	Gastric_Quiescent_Low
GM12878_Lymphoblastoid_Flanking_Bivalent_TSS_Enh	CD4pp_CD25pp_CD127__Treg_Primary_Cells_Heterochromatin
Fetal_Brain_Male_Bivalent_Poised_TSS	Mobilized_CD34_Primary_Cells_Female_ZNF_genes_and_repeats
Brain_Cingulate_Gyrus_Bivalent_Enhancer	CD3_Primary_Cells_Cord_BI_ZNF_genes_and_repeats
Fetal_Heart_Bivalent_Poised_TSS	Penis_Foreskin_Keratinocyte_Primary_Cells_skin02_Heterochromatin
Penis_Foreskin_Fibroblast_Primary_Cells_skin02_Bivalent_Poised_TSS	H1_Cell_Line_Genic_enhancers
CD4pp_CD25__IL17pp_PMA_Ionomcyin_stimulated_Th17_Primary_Cells_Flanking_Bivalent_TSS_Enh	iPS_18_Cell_Line_Transcr_at_gene_5_and_3
Penis_Foreskin_Melanocyte_Primary_Cells_skin01_Flanking_Bivalent_TSS_Enh	Stomach_Mucosa_Strong_transcription
Brain_Mid_Frontal_Lobe_Bivalent_Enhancer	Adipose_Derived_Mesenchymal_Stem_Cell_Cultured_Cells_Heterochromatin
Lung_Quiescent_Low	Fetal_Placenta_Heterochromatin
NHEK_Epidermal_Keratinocytes_Quiescent_Low	iPS_18_Cell_Line_Heterochromatin
Lung_Bivalent_Poised_TSS	Breast_Myoepithelial_Cells_Heterochromatin
Rectal_Mucosa.Donor_29_Flanking_Bivalent_TSS_Enh	Sigmoid_Colon_Heterochromatin
Breast_vHMEC_Flanking_Active_TSS	Aorta_Quiescent_Low
Colonic_Mucosa_Bivalent_Enhancer	Penis_Foreskin_Fibroblast_Primary_Cells_skin02_Heterochromatin
Brain_Anterior_Caudate_Bivalent_Enhancer	Monocytes_CD14pp_RO01746_Heterochromatin
Stomach_Smooth_Muscle_Bivalent_Enhancer	HUES48_Cell_Line_ZNF_genes_and_repeats
CD3_Primary_Cells_Cord_BI_Bivalent_Enhancer	iPS_20b_Cell_Line_Transcr_at_gene_5_and_3
Brain_Germinal_Matrix_Bivalent_Enhancer	Psoas_Muscle_Heterochromatin
Right_Ventricle_Flanking_Bivalent_TSS_Enh	HUES6_Cell_Line_Genic_enhancers
NHLF_Lung_Fibroblasts_Bivalent_Enhancer	Fetal_Intestine_Small_Strong_transcription
HMEC_Mammary_Epithelial_Bivalent_Enhancer	HUES48_Cell_Line_Weak_transcription
iPS_20b_Cell_Line_Flanking_Bivalent_TSS_Enh	IMR90_Cell_Line_Heterochromatin
Fetal_Intestine_Large_Flanking_Bivalent_TSS_Enh	Fetal_Brain_Female_Heterochromatin
Muscle_Satellite_Cultured_Cells_Flanking_Bivalent_TSS_Enh	HUES64_Cell_Line_Weak_transcription
Brain_Inferior_Temporal_Lobe_Bivalent_Enhancer	HUES48_Cell_Line_Heterochromatin
Osteoblasts_Bivalent_Enhancer	Penis_Foreskin_Fibroblast_Primary_Cells_skin01_Heterochromatin
Aorta_Quiescent_Low	4star_Heterochromatin
H1_BMP4_Derived_Mesendoderm_Cultured_Cells_Bivalent_Enhancer	iPS_15b_Cell_Line_Weak_transcription
Rectal_Mucosa.Donor_29_Bivalent_Enhancer	Fetal_Muscle_Trunk_Heterochromatin
Penis_Foreskin_Melanocyte_Primary_Cells_skin01_Bivalent_Poised_TSS	CD3_Primary_Cells_Cord_BI_Heterochromatin
Peripheral_Blood_Mononuclear_Primary_Cells_Flanking_Bivalent_TSS_Enh	CD14_Primary_Cells_Heterochromatin
Colon_Smooth_Muscle_Bivalent_Enhancer	iPS_20b_Cell_Line_ZNF_genes_and_repeats
Mesenchymal_Stem_Cell_Derived_Adipocyte_Cultured_Cells_Bivalent_Enhancer	Fetal_Stomach_Strong_transcription
Thymus_Bivalent_Enhancer	Fetal_Muscle_Leg_Heterochromatin
CD8_Memory_Primary_Cells_Bivalent_Poised_TSS	HUES64_Cell_Line_ZNF_genes_and_repeats
Penis_Foreskin_Melanocyte_Primary_Cells_skin01_Bivalent_Enhancer	Gastric_Strong_transcription
Fetal_Kidney_Flanking_Active_TSS	HUES64_Cell_Line_Genic_enhancers
Duodenum_Smooth_Muscle_Bivalent_Enhancer	Penis_Foreskin_Keratinocyte_Primary_Cells_skin03_Heterochromatin
ES_I3_Cell_Line_Flanking_Active_TSS	HUVEC_Umbilical_Vein_Endothelial_Cells_Heterochromatin
Dnd41_TCell_Leukemia_Bivalent_Poised_TSS	Duodenum_Mucosa_Heterochromatin
CD4pp_CD25__IL17pp_PMA_Ionomcyin_stimulated_Th17_Primary_Cells_Bivalent_Poised_TSS	H1_Derived_Mesenchymal_Stem_Cells_Strong_transcription
HUES48_Cell_Line_Flanking_Bivalent_TSS_Enh	Right_Ventricle_Strong_transcription
Stomach_Mucosa_Flanking_Active_TSS	Pancreatic_Islets_Strong_transcription
CD19_Primary_Cells_Cord_BI_Bivalent_Poised_TSS	Fetal_Heart_Strong_transcription
H1_BMP4_Derived_Trophoblast_Cultured_Cells_Bivalent_Poised_TSS	Penis_Foreskin_Melanocyte_Primary_Cells_skin01_Strong_transcription
NH_A_Astrocytes_Flanking_Bivalent_TSS_Enh	Spleen_Quiescent_Low
Neurosphere_Cultured_Cells_Cortex_Derived_Bivalent_Poised_TSS	iPS_15b_Cell_Line_Heterochromatin
Fetal_Kidney_Bivalent_Enhancer	IMR90_Cell_Line_Strong_transcription
CD4_Memory_Primary_Cells_Bivalent_Poised_TSS	Breast_vHMEC_Heterochromatin
HMEC_Mammary_Epithelial_Quiescent_Low	Lung_Quiescent_Low
Adipose_Nuclei_Bivalent_Poised_TSS	iPS_20b_Cell_Line_Weak_transcription
Brain_Substantia_Nigra_Bivalent_Enhancer	HUES48_Cell_Line_Genic_enhancers
CD4_Memory_Primary_Cells_Flanking_Bivalent_TSS_Enh	Adult_Liver_Quiescent_Low
CD14_Primary_Cells_Bivalent_Poised_TSS	Esophagus_Strong_transcription
Ovary_Bivalent_Enhancer	CD56_Primary_Cells_Heterochromatin
CD4pp_CD25__CD45RApp_Naive_Primary_Cells_Bivalent_Poised_TSS	Brain_Mid_Frontal_Lobe_Strong_transcription
H9_Derived_Neuronal_Progenitor_Cultured_Cells_Flanking_Bivalent_TSS_Enh	Penis_Foreskin_Fibroblast_Primary_Cells_skin02_Strong_transcription
Adult_Liver_Bivalent_Poised_TSS	Lung_Strong_transcription
Gastric_Bivalent_Enhancer	NHLF_Lung_Fibroblasts_Strong_transcription
IMR90_Cell_Line_Flanking_Bivalent_TSS_Enh	Fetal_Brain_Female_Strong_transcription
HUVEC_Umbilical_Vein_Endothelial_Cells_Bivalent_Poised_TSS	H1_Derived_Neuronal_Progenitor_Cultured_Cells_Quiescent_Low
H1_Derived_Mesenchymal_Stem_Cells_Flanking_Active_TSS	Stomach_Smooth_Muscle_Strong_transcription
Fetal_Brain_Female_Bivalent_Enhancer	Dnd41_TCell_Leukemia_Quiescent_Low
Brain_Inferior_Temporal_Lobe_Flanking_Bivalent_TSS_Enh	HeLa_S3_Cervical_Carcinoma_Quiescent_Low
Fetal_Adrenal_Gland_Quiescent_Low	Peripheral_Blood_Mononuclear_Primary_Cells_Strong_transcription
CD4_Naive_Primary_Cells_Bivalent_Poised_TSS	Pancreas_Strong_transcription
CD4pp_CD25__CD45ROpp_Memory_Primary_Cells_Bivalent_Poised_TSS	Penis_Foreskin_Melanocyte_Primary_Cells_skin03_Quiescent_Low
CD3_Primary_Cells_Peripheral_UW_Bivalent_Poised_TSS	Breast_Myoepithelial_Cells_Quiescent_Low
Breast_vHMEC_Quiescent_Low	iPS_20b_Cell_Line_Genic_enhancers
Ovary_Flanking_Active_TSS	H1_BMP4_Derived_Trophoblast_Cultured_Cells_Quiescent_Low
HUES64_Cell_Line_Flanking_Bivalent_TSS_Enh	Fetal_Muscle_Leg_Strong_transcription
Gastric_Bivalent_Poised_TSS	Breast_vHMEC_Quiescent_Low
Pancreas_Bivalent_Poised_TSS	Brain_Inferior_Temporal_Lobe_Strong_transcription
HSMMtube_Skeletal_Muscle_Myotubes_Derived_from_HSMM_Bivalent_Enhancer	Penis_Foreskin_Keratinocyte_Primary_Cells_skin02_Strong_transcription
Pancreatic_Islets_Flanking_Active_TSS	Breast_Myoepithelial_Cells_Strong_transcription
A549_EtOH_0.02pct_Lung_Carcinoma_Bivalent_Enhancer	Fetal_Muscle_Trunk_Strong_transcription
Esophagus_Flanking_Active_TSS	Brain_Germinal_Matrix_Strong_transcription
Brain_Cingulate_Gyrus_Flanking_Bivalent_TSS_Enh	HMEC_Mammary_Epithelial_Quiescent_Low
Osteoblasts_Flanking_Bivalent_TSS_Enh	Penis_Foreskin_Fibroblast_Primary_Cells_skin01_Strong_transcription
iPS_15b_Cell_Line_Flanking_Bivalent_TSS_Enh	Brain_Cingulate_Gyrus_Strong_transcription
Placenta_Amnion_Bivalent_Poised_TSS	Aorta_Strong_transcription
4star_Flanking_Active_TSS	CD15_Primary_Cells_Strong_transcription
GM12878_Lymphoblastoid_Quiescent_Low	A549_EtOH_0.02pct_Lung_Carcinoma_Quiescent_Low
H9_Derived_Neuronal_Progenitor_Cultured_Cells_Quiescent_Low	Skeletal_Muscle_Male_Strong_transcription
Rectal_Mucosa.Donor_31_Flanking_Bivalent_TSS_Enh	Mobilized_CD34_Primary_Cells_Male_Strong_transcription
CD4pp_CD25__CD45ROpp_Memory_Primary_Cells_Flanking_Bivalent_TSS_Enh	Thymus_Strong_transcription
HSMM_Skeletal_Muscle_Myoblasts_Bivalent_Enhancer	CD34_Cultured_Cells_Strong_transcription
H1_BMP4_Derived_Trophoblast_Cultured_Cells_Flanking_Active_TSS	Ovary_Quiescent_Low
Rectal_Smooth_Muscle_Bivalent_Enhancer	Colonic_Mucosa_Strong_transcription
Small_Intestine_Bivalent_Enhancer	CD3_Primary_Cells_Cord_BI_Strong_transcription
CD4_Naive_Primary_Cells_Flanking_Bivalent_TSS_Enh	Monocytes_CD14pp_RO01746_Strong_transcription
Bone_Marrow_Derived_Mesenchymal_Stem_Cell_Cultured_Cells_Bivalent_Enhancer	H1_BMP4_Derived_Trophoblast_Cultured_Cells_Strong_transcription
iPS_DF_19.11_Cell_Line_Flanking_Active_TSS	Fetal_Adrenal_Gland_Strong_transcription
Spleen_Bivalent_Poised_TSS	HepG2_Hepatocellular_Carcinoma_Heterochromatin
hESC_Derived_CD56pp_Ectoderm_Cultured_Cells_Flanking_Bivalent_TSS_Enh	Ovary_Strong_transcription
H1_BMP4_Derived_Trophoblast_Cultured_Cells_Flanking_Bivalent_TSS_Enh	GM12878_Lymphoblastoid_Quiescent_Low
hESC_Derived_CD56pp_Mesoderm_Cultured_Cells_Flanking_Active_TSS	Left_Ventricle_Quiescent_Low
Lung_Flanking_Active_TSS	Penis_Foreskin_Keratinocyte_Primary_Cells_skin03_Strong_transcription
Right_Ventricle_Bivalent_Enhancer	4star_Quiescent_Low
HMEC_Mammary_Epithelial_Bivalent_Poised_TSS	Fetal_Intestine_Large_Strong_transcription
Brain_Anterior_Caudate_Flanking_Bivalent_TSS_Enh	Neurosphere_Cultured_Cells_Cortex_Derived_Strong_transcription
Esophagus_Flanking_Bivalent_TSS_Enh	NHEK_Epidermal_Keratinocytes_Strong_transcription
Fetal_Placenta_Quiescent_Low	Brain_Hippocampus_Middle_Strong_transcription
CD56_Primary_Cells_Bivalent_Poised_TSS	Brain_Anterior_Caudate_Strong_transcription
CD8_Memory_Primary_Cells_Flanking_Bivalent_TSS_Enh	Esophagus_Quiescent_Low
Rectal_Smooth_Muscle_Flanking_Bivalent_TSS_Enh	Adult_Liver_Strong_transcription
Psoas_Muscle_Flanking_Active_TSS	Osteoblasts_Strong_transcription
CD4pp_CD25pp_CD127__Treg_Primary_Cells_Bivalent_Poised_TSS	Brain_Angular_Gyrus_Strong_transcription
Placenta_Amnion_Flanking_Active_TSS	Adipose_Nuclei_Strong_transcription
HepG2_Hepatocellular_Carcinoma_Quiescent_Low	HUVEC_Umbilical_Vein_Endothelial_Cells_Quiescent_Low
Left_Ventricle_Flanking_Active_TSS	CD14_Primary_Cells_Strong_transcription
CD8_Naive_Primary_Cells_Flanking_Bivalent_TSS_Enh	H9_Derived_Neuronal_Progenitor_Cultured_Cells_Strong_transcription
Psoas_Muscle_Flanking_Bivalent_TSS_Enh	Penis_Foreskin_Melanocyte_Primary_Cells_skin03_Strong_transcription
CD34_Primary_Cells_Bivalent_Poised_TSS	Psoas_Muscle_Quiescent_Low
Fetal_Lung_Flanking_Bivalent_TSS_Enh	hESC_Derived_CD56pp_Mesoderm_Cultured_Cells_Strong_transcription
Right_Atrium_Flanking_Active_TSS	ES_WA7_Cell_Line_Strong_transcription
Adult_Liver_Quiescent_Low	Adipose_Derived_Mesenchymal_Stem_Cell_Cultured_Cells_Strong_transcription
CD15_Primary_Cells_Bivalent_Poised_TSS	Brain_Anterior_Caudate_Quiescent_Low
Peripheral_Blood_Mononuclear_Primary_Cells_Bivalent_Enhancer	Sigmoid_Colon_Strong_transcription
Brain_Mid_Frontal_Lobe_Flanking_Bivalent_TSS_Enh	Fetal_Placenta_Strong_transcription
Bone_Marrow_Derived_Mesenchymal_Stem_Cell_Cultured_Cells_Flanking_Bivalent_TSS_Enh	Neurosphere_Cultured_Cells_Ganglionic_Eminence_Derived_Strong_transcription
Colon_Smooth_Muscle_Flanking_Bivalent_TSS_Enh	Duodenum_Mucosa_Strong_transcription
A549_EtOH_0.02pct_Lung_Carcinoma_Flanking_Bivalent_TSS_Enh	Rectal_Mucosa.Donor_29_Strong_transcription
Fetal_Muscle_Leg_Quiescent_Low	CD4pp_CD25__CD45RApp_Naive_Primary_Cells_Strong_transcription
Adult_Liver_Flanking_Bivalent_TSS_Enh	Mobilized_CD34_Primary_Cells_Female_Strong_transcription
Spleen_Flanking_Active_TSS	H9_Derived_Neuron_Cultured_Cells_Strong_transcription
hESC_Derived_CD184pp_Endoderm_Cultured_Cells_Flanking_Bivalent_TSS_Enh	CD4pp_CD25pp_CD127__Treg_Primary_Cells_Strong_transcription
hESC_Derived_CD56pp_Mesoderm_Cultured_Cells_Quiescent_Low	Bone_Marrow_Derived_Mesenchymal_Stem_Cell_Cultured_Cells_Strong_transcription
CD4pp_CD25__Th_Primary_Cells_Bivalent_Poised_TSS	hESC_Derived_CD56pp_Mesoderm_Cultured_Cells_Quiescent_Low
Bone_Marrow_Derived_Mesenchymal_Stem_Cell_Cultured_Cells_Quiescent_Low	Pancreatic_Islets_Quiescent_Low
Gastric_Flanking_Active_TSS	iPS_18_Cell_Line_ZNF_genes_and_repeats
Pancreatic_Islets_Flanking_Bivalent_TSS_Enh	CD4pp_CD25__IL17pp_PMA_Ionomcyin_stimulated_Th17_Primary_Cells_Strong_transcription
Ovary_Flanking_Bivalent_TSS_Enh	Chondrocytes_from_Bone_Marrow_Derived_Mesenchymal_Stem_Cell_Cultured_Cells_Strong_transcription
Fetal_Intestine_Small_Quiescent_Low	CD4pp_CD25int_CD127pp_Tmem_Primary_Cells_Strong_transcription
Mesenchymal_Stem_Cell_Derived_Adipocyte_Cultured_Cells_Flanking_Bivalent_TSS_Enh	Dnd41_TCell_Leukemia_Strong_transcription
Brain_Substantia_Nigra_Flanking_Bivalent_TSS_Enh	CD19_Primary_Cells_Cord_BI_Strong_transcription
Fetal_Brain_Male_Flanking_Bivalent_TSS_Enh	CD19_Primary_Cells_Peripheral_UW_Strong_transcription
CD19_Primary_Cells_Peripheral_UW_Bivalent_Poised_TSS	Skeletal_Muscle_Female_Strong_transcription
Right_Atrium_Bivalent_Enhancer	CD56_Primary_Cells_Strong_transcription
ES_WA7_Cell_Line_Genic_enhancers	CD3_Primary_Cells_Peripheral_UW_Strong_transcription
HeLa_S3_Cervical_Carcinoma_Bivalent_Enhancer	HSMMtube_Skeletal_Muscle_Myotubes_Derived_from_HSMM_Strong_transcription
Adipose_Nuclei_Quiescent_Low	Brain_Substantia_Nigra_Strong_transcription
Adipose_Derived_Mesenchymal_Stem_Cell_Cultured_Cells_Flanking_Bivalent_TSS_Enh	Placenta_Amnion_Strong_transcription
Brain_Angular_Gyrus_Flanking_Bivalent_TSS_Enh	Chondrocytes_from_Bone_Marrow_Derived_Mesenchymal_Stem_Cell_Cultured_Cells_Quiescent_Low
Placenta_Amnion_Flanking_Bivalent_TSS_Enh	HSMMtube_Skeletal_Muscle_Myotubes_Derived_from_HSMM_Quiescent_Low
Left_Ventricle_Flanking_Bivalent_TSS_Enh	Left_Ventricle_Strong_transcription
HUES64_Cell_Line_Quiescent_Low	HSMM_Skeletal_Muscle_Myoblasts_Quiescent_Low
H9_Derived_Neuron_Cultured_Cells_Quiescent_Low	iPS_18_Cell_Line_Genic_enhancers
HeLa_S3_Cervical_Carcinoma_Flanking_Bivalent_TSS_Enh	Mesenchymal_Stem_Cell_Derived_Adipocyte_Cultured_Cells_Strong_transcription
NHLF_Lung_Fibroblasts_Flanking_Bivalent_TSS_Enh	Duodenum_Smooth_Muscle_Strong_transcription
H1_Derived_Mesenchymal_Stem_Cells_Flanking_Bivalent_TSS_Enh	H9_Cell_Line_Quiescent_Low
Neurosphere_Cultured_Cells_Cortex_Derived_Quiescent_Low	HSMM_Skeletal_Muscle_Myoblasts_Strong_transcription
Psoas_Muscle_Bivalent_Enhancer	Rectal_Mucosa.Donor_31_Strong_transcription
H1_BMP4_Derived_Trophoblast_Cultured_Cells_Quiescent_Low	Penis_Foreskin_Keratinocyte_Primary_Cells_skin03_Quiescent_Low
HeLa_S3_Cervical_Carcinoma_Bivalent_Poised_TSS	CD4pp_CD25__Th_Primary_Cells_Strong_transcription
Mobilized_CD34_Primary_Cells_Female_Bivalent_Poised_TSS	Mesenchymal_Stem_Cell_Derived_Adipocyte_Cultured_Cells_Quiescent_Low
HSMMtube_Skeletal_Muscle_Myotubes_Derived_from_HSMM_Quiescent_Low	Bone_Marrow_Derived_Mesenchymal_Stem_Cell_Cultured_Cells_Quiescent_Low
Fetal_Heart_Flanking_Bivalent_TSS_Enh	NHEK_Epidermal_Keratinocytes_Quiescent_Low
HSMM_Skeletal_Muscle_Myoblasts_Flanking_Bivalent_TSS_Enh	Brain_Inferior_Temporal_Lobe_Quiescent_Low
Neurosphere_Cultured_Cells_Ganglionic_Eminence_Derived_Quiescent_Low	Muscle_Satellite_Cultured_Cells_Strong_transcription
Mobilized_CD34_Primary_Cells_Female_Quiescent_Low	NHDF_Ad_Adult_Dermal_Fibroblasts_Quiescent_Low
hESC_Derived_CD56pp_Mesoderm_Cultured_Cells_Flanking_Bivalent_TSS_Enh	Fetal_Thymus_Strong_transcription
Pancreatic_Islets_Bivalent_Enhancer	CD34_Primary_Cells_Quiescent_Low
Sigmoid_Colon_Flanking_Active_TSS	Fetal_Lung_Strong_transcription
Mobilized_CD34_Primary_Cells_Male_Bivalent_Poised_TSS	CD56_Primary_Cells_Quiescent_Low
Pancreas_Bivalent_Enhancer	IMR90_Cell_Line_Quiescent_Low
Lung_Flanking_Bivalent_TSS_Enh	HepG2_Hepatocellular_Carcinoma_Strong_transcription
ES_I3_Cell_Line_Flanking_Bivalent_TSS_Enh	Mobilized_CD34_Primary_Cells_Male_Quiescent_Low
Right_Atrium_Flanking_Bivalent_TSS_Enh	CD34_Primary_Cells_Strong_transcription
ES_I3_Cell_Line_Quiescent_Low	A549_EtOH_0.02pct_Lung_Carcinoma_Strong_transcription
H1_Derived_Neuronal_Progenitor_Cultured_Cells_Flanking_Active_TSS	Brain_Substantia_Nigra_Quiescent_Low
H9_Cell_Line_Flanking_Active_TSS	Brain_Angular_Gyrus_Quiescent_Low
iPS_DF_6.9_Cell_Line_Flanking_Bivalent_TSS_Enh	GM12878_Lymphoblastoid_Strong_transcription
NHDF_Ad_Adult_Dermal_Fibroblasts_Flanking_Bivalent_TSS_Enh	CD4_Naive_Primary_Cells_Strong_transcription
Aorta_Flanking_Active_TSS	HepG2_Hepatocellular_Carcinoma_Quiescent_Low
Stomach_Mucosa_Flanking_Bivalent_TSS_Enh	CD4pp_CD25__IL17__PMA_Ionomycin_stimulated_MACS_purified_Th_Primary_Cells_Strong_transcription
iPS_DF_6.9_Cell_Line_Flanking_Active_TSS	Rectal_Smooth_Muscle_Strong_transcription
Aorta_Flanking_Bivalent_TSS_Enh	HMEC_Mammary_Epithelial_Strong_transcription
H1_BMP4_Derived_Mesendoderm_Cultured_Cells_Flanking_Active_TSS	Colon_Smooth_Muscle_Strong_transcription
CD34_Cultured_Cells_Bivalent_Poised_TSS	Brain_Hippocampus_Middle_Quiescent_Low
Aorta_Bivalent_Enhancer	Sigmoid_Colon_Quiescent_Low
K562_Leukemia_Flanking_Bivalent_TSS_Enh	Adipose_Nuclei_Quiescent_Low
H1_Derived_Mesenchymal_Stem_Cells_Bivalent_Poised_TSS	Breast_vHMEC_Strong_transcription
Spleen_Flanking_Bivalent_TSS_Enh	Penis_Foreskin_Fibroblast_Primary_Cells_skin01_Quiescent_Low
CD34_Cultured_Cells_Quiescent_Low	HeLa_S3_Cervical_Carcinoma_Strong_transcription
4star_Quiescent_Low	H1_Derived_Mesenchymal_Stem_Cells_Quiescent_Low
Small_Intestine_Flanking_Bivalent_TSS_Enh	Adipose_Derived_Mesenchymal_Stem_Cell_Cultured_Cells_Quiescent_Low
HUES48_Cell_Line_Quiescent_Low	hESC_Derived_CD184pp_Endoderm_Cultured_Cells_Quiescent_Low
Muscle_Satellite_Cultured_Cells_Quiescent_Low	Neurosphere_Cultured_Cells_Ganglionic_Eminence_Derived_Quiescent_Low
Sigmoid_Colon_Flanking_Bivalent_TSS_Enh	K562_Leukemia_Strong_transcription
H9_Cell_Line_Flanking_Bivalent_TSS_Enh	Fetal_Placenta_Quiescent_Low
iPS_18_Cell_Line_Quiescent_Low	CD4_Memory_Primary_Cells_Strong_transcription
Fetal_Intestine_Large_Quiescent_Low	CD4pp_CD25__CD45ROpp_Memory_Primary_Cells_Strong_transcription
Small_Intestine_Flanking_Active_TSS	Muscle_Satellite_Cultured_Cells_Quiescent_Low
Penis_Foreskin_Keratinocyte_Primary_Cells_skin02_Quiescent_Low	Penis_Foreskin_Fibroblast_Primary_Cells_skin02_Quiescent_Low
H1_Derived_Neuronal_Progenitor_Cultured_Cells_Flanking_Bivalent_TSS_Enh	Mobilized_CD34_Primary_Cells_Female_Quiescent_Low
ES_WA7_Cell_Line_Flanking_Active_TSS	NHDF_Ad_Adult_Dermal_Fibroblasts_Strong_transcription
iPS_20b_Cell_Line_Quiescent_Low	Penis_Foreskin_Keratinocyte_Primary_Cells_skin02_Quiescent_Low
H1_BMP4_Derived_Mesendoderm_Cultured_Cells_Flanking_Bivalent_TSS_Enh	Right_Ventricle_Quiescent_Low
Fetal_Kidney_Flanking_Bivalent_TSS_Enh	Brain_Cingulate_Gyrus_Quiescent_Low
HSMMtube_Skeletal_Muscle_Myotubes_Derived_from_HSMM_Flanking_Bivalent_TSS_Enh	hESC_Derived_CD184pp_Endoderm_Cultured_Cells_Strong_transcription
Duodenum_Mucosa_Quiescent_Low	Osteoblasts_Quiescent_Low
Left_Ventricle_Quiescent_Low	CD8_Memory_Primary_Cells_Strong_transcription
Breast_vHMEC_Flanking_Bivalent_TSS_Enh	K562_Leukemia_Quiescent_Low
CD34_Primary_Cells_Quiescent_Low	Fetal_Intestine_Small_Quiescent_Low
CD56_Primary_Cells_Quiescent_Low	CD14_Primary_Cells_Quiescent_Low
ES_WA7_Cell_Line_Flanking_Bivalent_TSS_Enh	Colon_Smooth_Muscle_Quiescent_Low
Pancreatic_Islets_Quiescent_Low	Fetal_Adrenal_Gland_Quiescent_Low
Monocytes_CD14pp_RO01746_Quiescent_Low	Fetal_Lung_Quiescent_Low
Osteoblasts_Quiescent_Low	Duodenum_Smooth_Muscle_Quiescent_Low
HSMM_Skeletal_Muscle_Myoblasts_Quiescent_Low	Penis_Foreskin_Melanocyte_Primary_Cells_skin01_Quiescent_Low
Fetal_Stomach_Quiescent_Low	NH_A_Astrocytes_Strong_transcription
Brain_Hippocampus_Middle_Quiescent_Low	CD8_Naive_Primary_Cells_Strong_transcription
Dnd41_TCell_Leukemia_Quiescent_Low	Fetal_Brain_Female_Quiescent_Low
Fetal_Lung_Quiescent_Low	CD4pp_CD25__Th_Primary_Cells_Quiescent_Low
NHDF_Ad_Adult_Dermal_Fibroblasts_Quiescent_Low	Monocytes_CD14pp_RO01746_Quiescent_Low
Brain_Anterior_Caudate_Quiescent_Low	Duodenum_Mucosa_Quiescent_Low
iPS_15b_Cell_Line_Quiescent_Low	Neurosphere_Cultured_Cells_Cortex_Derived_Quiescent_Low
H1_Cell_Line_Quiescent_Low	CD34_Cultured_Cells_Quiescent_Low
Sigmoid_Colon_Quiescent_Low	H9_Derived_Neuron_Cultured_Cells_Quiescent_Low
A549_EtOH_0.02pct_Lung_Carcinoma_Quiescent_Low	CD19_Primary_Cells_Peripheral_UW_Quiescent_Low
Esophagus_Quiescent_Low	HUVEC_Umbilical_Vein_Endothelial_Cells_Strong_transcription
NH_A_Astrocytes_Quiescent_Low	iPS_18_Cell_Line_Weak_transcription
Pancreas_Quiescent_Low	Fetal_Intestine_Large_Quiescent_Low
Stomach_Smooth_Muscle_Quiescent_Low	Brain_Mid_Frontal_Lobe_Quiescent_Low
CD19_Primary_Cells_Peripheral_UW_Quiescent_Low	iPS_18_Cell_Line_Quiescent_Low
K562_Leukemia_Quiescent_Low	H1_Derived_Neuronal_Progenitor_Cultured_Cells_Strong_transcription
NHLF_Lung_Fibroblasts_Quiescent_Low	Fetal_Muscle_Leg_Quiescent_Low
Fetal_Brain_Female_Quiescent_Low	NHLF_Lung_Fibroblasts_Quiescent_Low
Right_Atrium_Quiescent_Low	CD4pp_CD25__IL17__PMA_Ionomycin_stimulated_MACS_purified_Th_Primary_Cells_Quiescent_Low
Psoas_Muscle_Quiescent_Low	Stomach_Smooth_Muscle_Quiescent_Low
Penis_Foreskin_Melanocyte_Primary_Cells_skin01_Quiescent_Low	Psoas_Muscle_Strong_transcription
iPS_DF_19.11_Cell_Line_Quiescent_Low	Fetal_Stomach_Quiescent_Low
CD15_Primary_Cells_Quiescent_Low	CD3_Primary_Cells_Cord_BI_Quiescent_Low
Spleen_Quiescent_Low	Rectal_Mucosa.Donor_31_Quiescent_Low
Fetal_Muscle_Trunk_Quiescent_Low	H9_Derived_Neuronal_Progenitor_Cultured_Cells_Quiescent_Low
H9_Cell_Line_Quiescent_Low	Fetal_Kidney_Strong_transcription
Fetal_Thymus_Quiescent_Low	CD4pp_CD25pp_CD127__Treg_Primary_Cells_Quiescent_Low
Brain_Inferior_Temporal_Lobe_Quiescent_Low	CD4pp_CD25__CD45ROpp_Memory_Primary_Cells_Quiescent_Low
CD3_Primary_Cells_Cord_BI_Quiescent_Low	Fetal_Brain_Male_Strong_transcription
CD19_Primary_Cells_Cord_BI_Quiescent_Low	Fetal_Kidney_Quiescent_Low
Brain_Germinal_Matrix_Quiescent_Low	NH_A_Astrocytes_Quiescent_Low
Skeletal_Muscle_Female_Quiescent_Low	CD19_Primary_Cells_Cord_BI_Quiescent_Low
Brain_Substantia_Nigra_Quiescent_Low	Fetal_Muscle_Trunk_Quiescent_Low
H1_Derived_Neuronal_Progenitor_Cultured_Cells_Quiescent_Low	Small_Intestine_Quiescent_Low
CD3_Primary_Cells_Peripheral_UW_Quiescent_Low	CD3_Primary_Cells_Peripheral_UW_Quiescent_Low
Brain_Cingulate_Gyrus_Quiescent_Low	Small_Intestine_Strong_transcription
CD4pp_CD25pp_CD127__Treg_Primary_Cells_Quiescent_Low	Brain_Germinal_Matrix_Quiescent_Low
Skeletal_Muscle_Male_Quiescent_Low	Right_Atrium_Quiescent_Low
Duodenum_Smooth_Muscle_Quiescent_Low	4star_Strong_transcription
Ovary_Quiescent_Low	HUES48_Cell_Line_Quiescent_Low
H1_BMP4_Derived_Mesendoderm_Cultured_Cells_Quiescent_Low	Rectal_Smooth_Muscle_Quiescent_Low
CD4pp_CD25__IL17__PMA_Ionomycin_stimulated_MACS_purified_Th_Primary_Cells_Quiescent_Low	hESC_Derived_CD56pp_Ectoderm_Cultured_Cells_Strong_transcription
CD4pp_CD25__Th_Primary_Cells_Quiescent_Low	Peripheral_Blood_Mononuclear_Primary_Cells_Quiescent_Low
Rectal_Mucosa.Donor_31_Quiescent_Low	iPS_15b_Cell_Line_Strong_transcription
Fetal_Brain_Male_Quiescent_Low	HUES6_Cell_Line_Quiescent_Low
hESC_Derived_CD56pp_Ectoderm_Cultured_Cells_Quiescent_Low	Skeletal_Muscle_Female_Quiescent_Low
Small_Intestine_Quiescent_Low	Fetal_Thymus_Quiescent_Low
Fetal_Heart_Quiescent_Low	CD8_Naive_Primary_Cells_Quiescent_Low
Stomach_Mucosa_Quiescent_Low	iPS_DF_19.11_Cell_Line_Quiescent_Low
Brain_Angular_Gyrus_Quiescent_Low	Fetal_Heart_Quiescent_Low
HeLa_S3_Cervical_Carcinoma_Quiescent_Low	HUES6_Cell_Line_Strong_transcription
Brain_Mid_Frontal_Lobe_Quiescent_Low	CD4pp_CD25__CD45RApp_Naive_Primary_Cells_Quiescent_Low
ES_WA7_Cell_Line_Quiescent_Low	HUES64_Cell_Line_Quiescent_Low
iPS_DF_6.9_Cell_Line_Quiescent_Low	CD15_Primary_Cells_Quiescent_Low
Right_Ventricle_Quiescent_Low	iPS_DF_6.9_Cell_Line_Quiescent_Low
Peripheral_Blood_Mononuclear_Primary_Cells_Quiescent_Low	Rectal_Mucosa.Donor_29_Quiescent_Low
Rectal_Mucosa.Donor_29_Quiescent_Low	H1_Cell_Line_Quiescent_Low
Colon_Smooth_Muscle_Quiescent_Low	ES_I3_Cell_Line_Quiescent_Low
Fetal_Kidney_Quiescent_Low	Fetal_Brain_Male_Quiescent_Low
CD8_Naive_Primary_Cells_Quiescent_Low	H9_Cell_Line_Strong_transcription
Thymus_Quiescent_Low	Skeletal_Muscle_Male_Quiescent_Low
CD4pp_CD25__IL17pp_PMA_Ionomcyin_stimulated_Th17_Primary_Cells_Quiescent_Low	CD4pp_CD25__IL17pp_PMA_Ionomcyin_stimulated_Th17_Primary_Cells_Quiescent_Low
Gastric_Quiescent_Low	iPS_20b_Cell_Line_Quiescent_Low
CD4pp_CD25__CD45ROpp_Memory_Primary_Cells_Quiescent_Low	iPS_DF_6.9_Cell_Line_Strong_transcription
Rectal_Smooth_Muscle_Quiescent_Low	H1_Cell_Line_Strong_transcription
CD4pp_CD25__CD45RApp_Naive_Primary_Cells_Quiescent_Low	CD4_Memory_Primary_Cells_Quiescent_Low
Colonic_Mucosa_Quiescent_Low	HUES64_Cell_Line_Strong_transcription
Placenta_Amnion_Quiescent_Low	ES_I3_Cell_Line_Strong_transcription
CD8_Memory_Primary_Cells_Quiescent_Low	HUES48_Cell_Line_Strong_transcription
CD4_Memory_Primary_Cells_Quiescent_Low	iPS_20b_Cell_Line_Strong_transcription
CD4_Naive_Primary_Cells_Quiescent_Low	iPS_18_Cell_Line_Strong_transcription
CD4pp_CD25int_CD127pp_Tmem_Primary_Cells_Quiescent_Low	CD4_Naive_Primary_Cells_Quiescent_Low
